parse metadata,infra.grpc.invoker,get metadata from header,parseDataReportFlag ok,DeleteFieldValues <:REQ:>,<:staticStrategies:>,rego exec input:<:MAP:>,computeOwnObjectIDs end,build <:*:> [trace.id=<:SEQ:> <:transactionID:> <:spanID:>,<:REQ:>,AuthListByName <:<:ChineseInfo:>:>,no need or no have tags [trace.id=<:SEQ:> <:transactionID:> <:spanID:>,getDept success,getBackupEmp success,Depts only have yunzhanghu,no need or no have tags,getPermTagsAndValues <:*:>,build <:*:>,build <:*:> <:*:> [trace.id=<:SEQ:> <:transactionID:> <:spanID:>,ClientEnvHandler is <:*:>,<:GIN:>,msg,no need compute team member perm,Response=<:MAP:>,message,approve callback start,svc.ApproveCallback failed,approve status error,superiorAndDeputy empty,loaded policy count:<:NUM:>,<:list modules:>,loadRegoMySQLInterval success,strconv.ParseIn<:updateFanweiEmployee failed:>,getBackupEm<:updateFanweiEmployee failed:>,callback status error,timestamp,unknown
5267,5267,5267,5267,2024,24,270,24,147,2024,123,24,132,122,118,24,24,270,123,30,30,0,24,6,6,6,6,6,8,2,2,2,10,10,0,2024-01-04 16:00:00,0
5231,5230,5230,5230,2006,24,271,24,144,2006,127,24,128,121,119,24,24,271,127,27,27,0,24,3,3,3,3,3,4,2,2,2,7,7,0,2024-01-04 16:02:00,0
5274,5275,5275,5275,2027,24,374,24,145,2027,229,24,132,120,119,24,24,374,229,28,28,0,24,4,4,4,4,3,2,2,2,2,12,12,1,2024-01-04 16:04:00,0
5237,5237,5237,5237,2019,24,257,24,147,2019,110,24,129,120,118,24,24,257,110,30,30,10,24,6,6,6,6,5,4,2,2,2,9,9,1,2024-01-04 16:06:00,0
5271,5271,5271,5271,2027,24,276,24,144,2027,132,24,126,120,118,24,24,276,132,27,27,0,24,3,3,3,3,3,4,2,2,2,6,6,0,2024-01-04 16:08:00,0
5221,5220,5220,5220,2020,24,246,24,145,2020,101,24,130,122,118,24,24,246,101,27,27,0,24,3,3,3,3,3,8,2,2,2,8,8,0,2024-01-04 16:10:00,0
5255,5256,5256,5256,2022,30,275,25,143,2023,132,25,123,120,117,25,24,275,132,27,27,0,24,3,3,3,3,3,6,2,2,2,3,3,0,2024-01-04 16:12:00,2
5256,5255,5255,5255,2032,22,255,22,148,2032,107,22,127,121,119,22,22,255,107,30,30,0,22,6,6,6,6,6,4,2,2,2,6,6,0,2024-01-04 16:14:00,0
5261,5261,5261,5261,2027,24,270,24,144,2027,126,24,128,121,120,24,24,270,126,27,27,0,24,3,3,3,3,3,2,2,2,2,7,7,0,2024-01-04 16:16:00,0
5245,5246,5246,5246,2011,24,273,24,144,2011,129,24,132,122,118,24,24,273,129,27,27,0,24,3,3,3,3,3,8,2,2,2,10,10,0,2024-01-04 16:18:00,0
5261,5259,5260,5260,2022,24,273,24,147,2022,126,24,127,121,118,24,24,273,126,30,30,0,24,6,6,6,6,6,6,2,2,2,6,6,0,2024-01-04 16:20:00,0
5235,5235,5234,5234,2020,24,259,24,144,2020,115,24,124,119,118,24,24,259,115,27,27,0,24,3,3,3,3,3,2,2,2,2,5,5,0,2024-01-04 16:22:00,0
5245,5246,5246,5246,2028,24,254,24,144,2028,110,24,125,122,118,24,24,254,110,27,27,0,24,3,3,3,3,2,8,2,2,2,3,3,1,2024-01-04 16:24:00,0
5255,5254,5255,5255,2018,24,278,24,145,2018,133,24,130,120,118,24,24,278,133,28,28,0,24,4,4,4,4,3,4,2,2,2,10,10,1,2024-01-04 16:26:00,0
5252,5254,5253,5253,2024,24,264,24,147,2024,117,24,131,124,118,24,24,264,117,30,30,0,24,6,6,6,6,6,12,2,2,2,7,7,0,2024-01-04 16:28:00,0
5263,5260,5260,5260,2034,24,252,24,145,2034,107,24,128,121,118,24,24,252,107,27,27,0,24,3,3,3,3,3,6,2,2,2,7,7,0,2024-01-04 16:30:00,0
5228,5230,5230,5230,2016,24,265,24,143,2016,122,24,130,121,118,24,24,265,122,27,27,18,24,3,3,3,3,3,6,2,2,2,9,9,0,2024-01-04 16:32:00,0
5183,5183,5183,5183,2033,24,194,24,145,2033,49,24,120,119,118,24,24,194,49,27,27,0,24,3,3,3,3,3,2,2,2,2,1,1,0,2024-01-04 16:34:00,0
5150,5150,5150,5150,2019,24,184,24,146,2019,38,24,120,119,118,24,24,184,38,30,30,0,24,6,6,6,6,6,2,2,2,2,1,1,0,2024-01-04 16:36:00,0
5191,5192,5192,5192,2028,24,202,24,145,2028,57,24,125,120,118,24,24,202,57,27,27,0,24,3,3,3,3,3,4,2,2,2,5,5,0,2024-01-04 16:38:00,0
5170,5168,5168,5168,2029,22,186,22,144,2029,42,22,122,120,118,22,22,186,42,27,27,0,22,3,3,3,3,3,4,2,2,2,2,2,0,2024-01-04 16:40:00,0
5140,5142,5141,5141,2016,24,184,24,147,2016,37,24,120,120,118,24,24,184,37,30,30,0,24,6,6,6,6,5,4,2,2,2,0,0,1,2024-01-04 16:42:00,0
5180,5181,5181,5181,2034,24,189,24,146,2034,43,24,121,119,118,24,24,189,43,28,28,4,24,4,4,4,4,3,2,2,2,2,2,2,1,2024-01-04 16:44:00,0
5145,5145,5145,5145,2024,24,170,24,144,2024,26,24,120,120,118,24,24,170,26,27,27,0,24,3,3,3,3,3,4,2,2,2,0,0,0,2024-01-04 16:46:00,0
5165,5165,5165,5165,2029,24,185,24,144,2029,41,24,118,118,118,24,24,185,41,27,27,0,24,3,3,3,3,3,0,2,2,2,0,0,0,2024-01-04 16:48:00,0
5157,5180,5157,5157,2021,24,239,24,148,2021,91,24,124,121,118,24,24,239,40,31,31,0,24,7,7,6,6,6,6,2,2,2,3,3,0,2024-01-04 16:50:00,52
5173,5173,5173,5173,2027,24,194,24,144,2027,50,24,121,118,118,24,24,194,50,27,27,0,24,3,3,3,3,3,0,2,2,2,3,3,0,2024-01-04 16:52:00,0
5130,5131,5130,5130,2011,24,186,24,143,2011,43,24,119,117,117,24,24,186,43,27,27,0,24,3,3,3,3,3,0,2,2,2,2,2,0,2024-01-04 16:54:00,0
5159,5158,5158,5158,2026,24,177,24,144,2026,33,24,125,120,118,24,24,177,33,27,27,0,24,3,3,3,3,3,4,2,2,2,5,5,0,2024-01-04 16:56:00,0
5159,5160,5160,5160,2018,24,196,24,147,2018,49,24,121,118,118,24,24,196,49,30,30,0,24,6,6,6,6,6,0,2,2,2,3,3,0,2024-01-04 16:58:00,0
5177,5177,5177,5177,2031,24,185,24,144,2031,41,24,123,120,119,24,24,185,41,27,27,0,24,3,3,3,3,3,2,2,2,2,3,3,0,2024-01-04 17:00:00,0
5160,5158,5158,5158,2019,24,294,24,146,2019,148,24,122,120,119,24,24,294,148,28,28,0,24,4,4,4,4,2,2,2,2,2,2,2,2,2024-01-04 17:02:00,0
5153,5154,5154,5154,2017,22,192,22,147,2017,45,22,122,119,118,22,22,192,45,30,30,0,22,6,6,6,6,6,2,2,2,2,3,3,0,2024-01-04 17:04:00,0
5153,5153,5153,5153,2019,24,188,24,143,2019,45,24,120,119,118,24,24,188,45,27,27,0,24,3,3,3,3,3,2,2,2,2,1,1,0,2024-01-04 17:06:00,0
5183,5184,5184,5184,2030,24,195,24,145,2030,50,24,122,120,118,24,24,195,50,27,27,0,24,3,3,3,3,3,4,2,2,2,2,2,0,2024-01-04 17:08:00,0
5174,5174,5174,5174,2031,24,187,24,144,2031,43,24,121,120,118,24,24,187,43,27,27,0,24,3,3,3,3,3,4,2,2,2,1,1,0,2024-01-04 17:10:00,0
5188,5189,5188,5188,2025,24,216,24,147,2025,69,24,123,120,119,24,24,216,69,30,30,4,24,6,6,6,6,6,2,2,2,2,3,3,0,2024-01-04 17:12:00,0
5205,5204,5204,5204,2028,24,390,24,317,2028,73,24,132,124,119,24,24,390,73,199,199,0,24,89,3,3,3,3,10,2,2,2,8,8,0,2024-01-04 17:14:00,258
5205,5206,5206,5206,2007,24,282,24,158,2007,124,24,131,126,117,24,24,282,124,42,42,0,24,11,3,3,3,3,18,2,2,2,5,5,0,2024-01-04 17:16:00,24
5250,5250,5250,5250,2033,24,263,24,147,2033,116,24,130,120,118,24,24,263,116,30,30,0,24,6,6,6,6,6,4,2,2,2,10,10,0,2024-01-04 17:18:00,0
5220,5220,5220,5220,2021,30,245,25,144,2022,101,25,132,123,119,25,24,245,101,27,27,0,24,3,3,3,3,2,8,2,2,2,9,9,1,2024-01-04 17:20:00,2
5247,5247,5247,5247,2017,30,286,25,147,2018,139,25,125,120,118,25,24,286,139,30,30,2,24,5,4,4,4,3,4,2,2,2,5,5,1,2024-01-04 17:22:00,5
5161,5161,5161,5161,2023,24,195,24,144,2023,51,24,121,118,118,24,24,195,51,27,27,3,24,3,3,3,3,3,0,2,2,2,3,3,0,2024-01-04 17:24:00,0
5181,5181,5181,5181,2023,24,212,24,147,2023,65,24,125,118,117,24,24,212,65,30,30,0,24,6,6,6,6,6,2,2,2,2,7,7,0,2024-01-04 17:26:00,0
5175,5174,5174,5174,2020,24,207,24,144,2020,63,24,124,118,118,24,24,207,63,27,27,0,24,3,3,3,3,3,0,2,2,2,6,6,0,2024-01-04 17:28:00,0
5178,5202,5179,5179,2026,22,200,22,144,2026,56,22,125,121,118,22,22,200,56,27,27,0,22,3,3,3,3,3,6,2,2,2,4,4,0,2024-01-04 17:30:00,0
5192,5191,5191,5191,2032,24,199,24,145,2032,54,24,125,119,119,24,24,199,54,27,27,0,24,3,3,3,3,3,0,2,2,2,6,6,0,2024-01-04 17:32:00,0
5196,5218,5197,5197,2029,24,211,24,147,2029,64,24,127,121,118,24,24,211,64,30,30,0,24,6,6,6,6,6,6,2,2,2,6,6,0,2024-01-04 17:34:00,0
5136,5136,5136,5136,2010,24,190,24,146,2010,44,24,121,118,118,24,24,190,44,29,29,0,24,4,3,3,3,3,0,2,2,2,3,3,0,2024-01-04 17:36:00,3
5162,5165,5161,5161,2024,24,188,24,145,2024,43,24,121,120,118,24,24,188,43,28,28,0,24,4,4,4,4,3,4,2,2,2,1,1,1,2024-01-04 17:38:00,0
5120,5120,5120,5120,2009,24,195,24,146,2009,49,24,121,118,117,24,24,195,49,30,30,0,24,6,6,6,6,5,2,2,2,2,3,3,1,2024-01-04 17:40:00,0
5200,5203,5200,5200,2012,24,250,24,144,2012,106,24,127,122,119,24,24,250,106,27,27,4,24,3,3,3,3,3,6,2,2,2,5,5,0,2024-01-04 17:42:00,0
5268,5269,5269,5269,2017,24,303,24,144,2017,159,24,131,123,119,24,24,303,159,27,27,0,24,3,3,3,3,3,8,2,2,2,8,8,0,2024-01-04 17:44:00,0
5244,5245,5244,5244,2018,24,284,24,144,2018,140,24,127,124,119,24,24,284,140,27,27,0,24,3,3,3,3,3,10,2,2,2,3,3,0,2024-01-04 17:46:00,2
5230,5230,5230,5230,2019,24,272,24,149,2019,123,24,127,119,119,24,24,272,123,32,32,6,24,7,6,6,6,6,0,2,2,2,8,8,0,2024-01-04 17:48:00,3
5245,5244,5244,5244,2026,24,268,24,146,2026,122,24,130,121,118,24,24,268,122,29,29,1,24,4,3,3,3,3,6,2,2,2,9,9,0,2024-01-04 17:50:00,3
5202,5226,5202,5202,2029,24,226,24,145,2029,81,24,125,122,118,24,24,226,81,27,27,2,24,3,3,3,3,3,8,2,2,2,3,3,0,2024-01-04 17:52:00,0
5176,5178,5177,5177,2024,22,209,22,146,2024,63,22,122,119,118,22,22,209,63,29,29,0,22,4,3,3,3,3,2,2,2,2,3,3,0,2024-01-04 17:54:00,3
5173,5173,5173,5173,2027,24,204,24,147,2027,57,24,122,120,118,24,24,204,57,30,30,0,24,6,6,6,6,6,4,2,2,2,2,2,0,2024-01-04 17:56:00,0
5164,5163,5163,5163,2020,24,202,24,144,2020,58,24,121,120,117,24,24,202,58,27,27,0,24,3,3,3,3,2,6,2,2,2,1,1,1,2024-01-04 17:58:00,0
5165,5166,5166,5166,2021,24,196,24,145,2021,51,24,124,119,119,24,24,196,51,28,28,0,24,4,4,4,4,3,0,2,2,2,5,5,1,2024-01-04 18:00:00,0
5113,5116,5112,5112,1991,24,213,24,146,1991,67,24,120,117,117,24,24,213,67,30,30,5,24,6,6,6,6,6,0,2,2,2,3,3,0,2024-01-04 18:02:00,0
5175,5176,5176,5176,2035,24,192,24,145,2035,47,24,123,120,120,24,24,192,47,27,27,4,24,3,3,3,3,3,0,2,2,2,3,3,0,2024-01-04 18:04:00,0
5150,5149,5149,5149,2014,24,207,24,144,2014,63,24,118,118,117,24,24,207,63,28,28,0,24,4,4,4,4,3,2,2,2,2,0,0,1,2024-01-04 18:06:00,0
5210,5211,5211,5211,2043,24,205,24,146,2043,59,24,122,120,119,24,24,205,59,27,27,4,24,3,3,3,3,3,2,2,2,2,2,2,0,2024-01-04 18:08:00,0
5181,5180,5180,5180,2035,24,196,24,148,2035,48,24,121,120,118,24,24,196,48,31,31,0,24,7,7,7,7,6,4,2,2,2,1,1,1,2024-01-04 18:10:00,0
5163,5164,5164,5164,2016,24,205,24,144,2016,61,24,122,119,118,24,24,205,61,27,27,0,24,3,3,3,3,3,2,2,2,2,3,3,0,2024-01-04 18:12:00,0
5142,5144,5142,5142,2014,24,190,24,145,2014,45,24,126,120,119,24,24,190,45,28,28,0,24,4,4,4,4,4,2,2,2,2,6,6,0,2024-01-04 18:14:00,0
5145,5145,5145,5145,2020,24,187,24,145,2020,42,24,120,119,118,24,24,187,42,28,28,0,24,4,4,4,4,4,2,2,2,2,1,1,0,2024-01-04 18:16:00,0
5179,5201,5178,5178,2026,23,207,23,147,2026,60,23,123,118,118,23,23,207,60,30,30,0,23,6,6,6,6,6,0,2,2,2,5,5,0,2024-01-04 18:18:00,0
5162,5163,5163,5163,2015,23,209,23,144,2015,65,23,122,119,118,23,23,209,65,27,27,2,23,3,3,3,3,3,2,2,2,2,3,3,0,2024-01-04 18:20:00,0
5161,5161,5161,5161,2015,24,205,24,145,2015,60,24,125,120,118,24,24,205,60,28,28,3,24,4,4,4,4,3,4,2,2,2,5,5,1,2024-01-04 18:22:00,0
5193,5195,5193,5193,2034,24,205,24,148,2034,57,24,124,119,118,24,24,205,57,30,30,1,24,6,6,6,6,6,2,2,2,2,5,5,0,2024-01-04 18:24:00,0
5121,5122,5121,5121,2010,24,189,24,143,2010,46,24,121,120,117,24,24,189,46,27,27,0,24,3,3,3,3,3,6,2,2,2,1,1,0,2024-01-04 18:26:00,0
5177,5177,5177,5177,2027,24,205,24,145,2027,60,24,122,120,118,24,24,205,60,28,28,0,24,4,4,4,4,3,4,2,2,2,2,2,1,2024-01-04 18:28:00,0
5210,5212,5210,5210,2041,24,213,24,145,2041,68,24,124,120,119,24,24,213,68,27,27,7,24,3,3,3,3,3,2,2,2,2,4,4,0,2024-01-04 18:30:00,0
5156,5156,5156,5156,2018,24,209,24,148,2018,61,24,120,119,118,24,24,209,61,31,31,0,24,7,7,7,7,7,2,2,2,2,1,1,0,2024-01-04 18:32:00,0
5203,5202,5202,5202,2027,24,228,24,144,2027,84,24,121,119,118,24,24,228,84,27,27,0,24,3,3,3,3,3,2,2,2,2,2,2,0,2024-01-04 18:34:00,0
5196,5197,5197,5197,2029,24,217,24,145,2029,72,24,125,120,118,24,24,217,72,28,28,0,24,4,4,4,4,4,4,2,2,2,5,5,0,2024-01-04 18:36:00,0
5200,5200,5200,5200,2030,24,213,24,148,2030,65,24,125,120,118,24,24,213,65,30,30,0,24,6,6,6,6,6,4,2,2,2,5,5,0,2024-01-04 18:38:00,0
5182,5181,5181,5181,2023,24,215,24,145,2023,70,24,122,119,118,24,24,215,70,28,28,0,24,4,4,4,4,3,2,2,2,2,3,3,1,2024-01-04 18:40:00,0
5138,5138,5138,5138,2008,24,206,24,143,2008,63,24,119,118,118,24,24,206,63,27,27,0,24,3,3,3,3,3,0,2,2,2,1,1,0,2024-01-04 18:42:00,0
5167,5168,5168,5168,2019,22,207,22,145,2019,62,22,127,121,118,22,22,207,62,28,28,0,22,4,4,4,4,3,6,2,2,2,6,6,1,2024-01-04 18:44:00,0
5186,5185,5185,5185,2022,24,224,24,147,2022,77,24,126,120,117,24,24,224,77,30,30,0,24,6,6,6,6,6,6,2,2,2,6,6,0,2024-01-04 18:46:00,0
5139,5140,5140,5140,2003,24,217,24,144,2003,73,24,121,117,117,24,24,217,73,28,28,0,24,4,4,4,4,4,0,2,2,2,4,4,0,2024-01-04 18:48:00,0
5195,5195,5195,5195,2036,24,255,24,145,2036,110,24,124,121,119,24,24,255,59,28,28,0,24,4,4,3,3,3,4,2,2,2,3,3,0,2024-01-04 18:50:00,52
5182,5182,5182,5182,2029,24,208,24,149,2029,59,24,120,119,118,24,24,208,59,31,31,0,24,7,7,7,7,7,2,2,2,2,1,1,0,2024-01-04 18:52:00,0
5172,5171,5171,5171,2017,24,210,24,143,2017,67,24,126,119,117,24,24,210,67,27,27,0,24,3,3,3,3,3,4,2,2,2,7,7,0,2024-01-04 18:54:00,0
5204,5205,5205,5205,2023,24,226,24,144,2023,82,24,129,123,119,24,24,226,82,27,27,0,24,3,3,3,3,3,8,2,2,2,6,6,0,2024-01-04 18:56:00,0
5166,5166,5166,5166,2017,24,206,24,145,2017,61,24,125,121,118,24,24,206,61,28,28,0,24,4,4,4,4,3,6,2,2,2,4,4,1,2024-01-04 18:58:00,0
5192,5192,5192,5192,2027,24,219,24,147,2027,72,24,125,120,118,24,24,219,72,30,30,0,24,6,6,6,6,6,4,2,2,2,5,5,0,2024-01-04 19:00:00,0
5133,5132,5132,5132,2003,24,309,24,145,2003,164,24,122,119,118,24,24,309,164,28,28,0,24,4,4,4,4,3,2,2,2,2,3,3,1,2024-01-04 19:02:00,0
5143,5144,5144,5144,2016,24,196,24,143,2016,53,24,121,118,118,24,24,196,53,27,27,0,24,3,3,3,3,3,0,2,2,2,3,3,0,2024-01-04 19:04:00,0
5144,5166,5143,5143,2017,24,194,24,145,2017,49,24,119,118,117,24,24,194,49,28,28,0,24,4,4,4,4,4,2,2,2,2,1,1,0,2024-01-04 19:06:00,0
5184,5184,5184,5184,2026,22,219,22,147,2026,72,22,123,119,118,22,22,219,72,30,30,0,22,6,6,6,6,6,2,2,2,2,4,4,0,2024-01-04 19:08:00,0
5114,5138,5115,5115,1997,24,209,24,144,1997,65,24,120,118,117,24,24,209,65,28,28,0,24,4,4,4,4,4,2,2,2,2,2,2,0,2024-01-04 19:10:00,0
5167,5167,5167,5167,2023,24,200,24,144,2023,56,24,120,120,118,24,24,200,56,27,27,0,24,3,3,3,3,3,4,2,2,2,0,0,0,2024-01-04 19:12:00,0
5198,5198,5198,5198,2042,24,202,24,149,2042,53,24,121,120,119,24,24,202,53,31,31,0,24,7,7,7,7,6,2,2,2,2,1,1,1,2024-01-04 19:14:00,0
5165,5164,5164,5164,2023,24,194,24,144,2023,50,24,123,120,119,24,24,194,50,27,27,0,24,3,3,3,3,3,2,2,2,2,3,3,0,2024-01-04 19:16:00,0
5164,5164,5164,5164,2028,24,186,24,144,2028,42,24,125,122,119,24,24,186,42,27,27,0,24,3,3,3,3,3,6,2,2,2,3,3,0,2024-01-04 19:18:00,0
5204,5205,5205,5205,2036,24,216,24,146,2036,70,24,121,120,118,24,24,216,70,28,28,0,24,4,4,4,4,3,4,2,2,2,1,1,1,2024-01-04 19:20:00,0
5181,5181,5181,5181,2017,24,223,24,148,2017,75,24,126,121,119,24,24,223,75,31,31,0,24,7,7,7,7,7,4,2,2,2,5,5,0,2024-01-04 19:22:00,0
5144,5144,5144,5144,2008,24,201,24,144,2008,57,24,124,121,117,24,24,201,57,27,27,0,24,3,3,3,3,3,8,2,2,2,3,3,0,2024-01-04 19:24:00,0
5213,5213,5213,5213,2040,24,213,24,145,2040,68,24,124,120,119,24,24,213,68,27,27,0,24,3,3,3,3,3,2,2,2,2,4,4,0,2024-01-04 19:26:00,0
5197,5197,5197,5197,2030,24,221,24,148,2030,73,24,124,120,118,24,24,221,73,31,31,0,24,7,7,7,7,7,4,2,2,2,4,4,0,2024-01-04 19:28:00,0
5200,5199,5199,5199,2033,24,216,24,145,2033,71,24,120,119,118,24,24,216,71,27,27,0,24,3,3,3,3,3,2,2,2,2,1,1,0,2024-01-04 19:30:00,0
5162,5163,5163,5163,2019,22,207,22,144,2019,63,22,126,120,118,22,22,207,63,27,27,0,22,4,4,4,4,3,4,2,2,2,6,6,1,2024-01-04 19:32:00,0
5196,5195,5195,5195,2033,24,207,24,144,2033,63,24,124,121,118,24,24,207,63,27,27,0,24,3,3,3,3,3,6,2,2,2,3,3,0,2024-01-04 19:34:00,0
5170,5171,5171,5171,2018,24,213,24,148,2018,65,24,120,119,118,24,24,213,65,31,31,0,24,7,7,7,7,6,2,2,2,2,1,1,1,2024-01-04 19:36:00,0
5194,5194,5194,5194,2020,24,226,24,143,2020,83,24,130,121,118,24,24,226,83,27,27,0,24,3,3,3,3,3,6,2,2,2,9,9,0,2024-01-04 19:38:00,0
5159,5158,5158,5158,2014,24,200,24,145,2014,55,24,126,119,118,24,24,200,55,28,28,0,24,4,4,4,4,4,2,2,2,2,7,7,0,2024-01-04 19:40:00,0
5176,5174,5174,5174,2021,24,206,24,144,2021,62,24,126,120,118,24,24,206,62,27,27,0,24,3,3,3,3,3,4,2,2,2,6,6,0,2024-01-04 19:42:00,0
5158,5160,5160,5160,2012,24,212,24,149,2012,63,24,125,122,118,24,24,212,63,32,32,0,24,7,7,7,7,7,8,2,2,2,3,3,0,2024-01-04 19:44:00,0
5164,5162,5162,5162,2016,24,206,24,143,2016,63,24,122,118,118,24,24,206,63,27,27,0,24,3,3,3,3,3,0,2,2,2,4,4,0,2024-01-04 19:46:00,0
5191,5194,5194,5194,2019,24,240,24,145,2019,95,24,118,118,117,24,24,240,95,28,28,0,24,4,4,4,4,3,2,2,2,2,0,0,1,2024-01-04 19:48:00,0
5209,5209,5209,5209,2034,24,273,24,149,2034,124,24,126,120,119,24,24,273,73,31,31,0,24,7,7,6,6,6,2,2,2,2,6,6,0,2024-01-04 19:50:00,52
5166,5166,5166,5166,2018,24,209,24,144,2018,65,24,119,119,118,24,24,209,65,27,27,0,24,3,3,3,3,3,2,2,2,2,0,0,0,2024-01-04 19:52:00,0
5136,5136,5136,5136,2009,22,206,22,143,2009,63,22,123,121,118,22,22,206,63,27,27,0,22,4,4,4,4,3,6,2,2,2,2,2,1,2024-01-04 19:54:00,0
5185,5185,5185,5185,2030,24,201,24,145,2030,56,24,121,118,118,24,24,201,56,27,27,0,24,3,3,3,3,3,0,2,2,2,3,3,0,2024-01-04 19:56:00,0
5186,5205,5186,5186,2024,24,224,24,148,2024,76,24,120,119,118,24,24,224,76,31,31,0,24,7,7,7,7,7,2,2,2,2,1,1,0,2024-01-04 19:58:00,0
5162,5161,5161,5161,2024,24,193,24,144,2024,49,24,122,122,118,24,24,193,49,27,27,9,24,3,3,3,3,3,8,2,2,2,0,0,0,2024-01-04 20:00:00,0
5166,5165,5165,5165,2012,24,318,24,145,2012,173,24,121,119,118,24,24,318,173,28,28,2,24,4,4,4,4,4,2,2,2,2,2,2,0,2024-01-04 20:02:00,0
5182,5183,5183,5183,2022,24,215,24,145,2022,70,24,125,121,119,24,24,215,70,28,28,0,24,4,4,4,4,3,4,2,2,2,4,4,1,2024-01-04 20:04:00,0
5184,5182,5182,5182,2023,24,217,24,148,2023,69,24,124,121,118,24,24,217,69,31,31,0,24,7,7,7,7,7,6,2,2,2,3,3,0,2024-01-04 20:06:00,0
5171,5174,5174,5174,2015,24,218,24,143,2015,75,24,121,119,118,24,24,218,75,27,27,0,24,3,3,3,3,3,2,2,2,2,2,2,0,2024-01-04 20:08:00,0
5192,5192,5192,5192,2032,24,212,24,146,2032,66,24,119,118,118,24,24,212,66,28,28,0,24,4,4,4,4,3,0,2,2,2,1,1,1,2024-01-04 20:10:00,0
5139,5139,5139,5139,2007,24,200,24,148,2007,52,24,124,121,118,24,24,200,52,32,32,0,24,8,8,8,8,8,6,2,2,2,3,3,0,2024-01-04 20:12:00,0
5188,5188,5188,5188,2031,24,208,24,145,2031,63,24,122,119,118,24,24,208,63,27,27,0,24,3,3,3,3,3,2,2,2,2,3,3,0,2024-01-04 20:14:00,0
5167,5166,5166,5166,2020,24,200,24,145,2020,55,24,126,123,118,24,24,200,55,28,28,0,24,4,4,4,4,4,10,2,2,2,3,3,0,2024-01-04 20:16:00,0
5108,5108,5108,5108,2010,22,178,22,144,2010,34,22,119,117,117,22,22,178,34,28,28,0,22,4,4,4,4,4,0,2,2,2,2,2,0,2024-01-04 20:18:00,0
5217,5218,5218,5218,2037,24,227,24,149,2037,78,24,122,119,119,24,24,227,78,31,31,0,24,7,7,7,7,6,0,2,2,2,3,3,1,2024-01-04 20:20:00,0
5168,5168,5168,5168,2012,24,216,24,145,2012,71,24,128,120,118,24,24,216,71,28,28,0,24,4,4,4,4,4,4,2,2,2,8,8,0,2024-01-04 20:22:00,0
5202,5202,5202,5202,2026,24,228,24,145,2026,83,24,122,120,118,24,24,228,83,28,28,0,24,4,4,4,4,3,4,2,2,2,2,2,1,2024-01-04 20:24:00,0
5155,5155,5155,5155,2018,24,200,24,148,2018,52,24,123,120,118,24,24,200,52,31,31,0,24,7,7,7,7,7,4,2,2,2,3,3,0,2024-01-04 20:26:00,0
5161,5160,5160,5160,2013,24,202,24,144,2013,58,24,126,121,118,24,24,202,58,28,28,0,24,4,4,4,4,4,6,2,2,2,5,5,0,2024-01-04 20:28:00,0
5169,5169,5169,5169,2021,24,197,24,144,2021,53,24,124,119,117,24,24,197,53,27,27,0,24,3,3,3,3,3,4,2,2,2,5,5,0,2024-01-04 20:30:00,0
5204,5205,5205,5205,2032,24,223,24,146,2032,77,24,124,121,119,24,24,223,77,28,28,0,24,4,4,4,4,4,4,2,2,2,3,3,0,2024-01-04 20:32:00,0
5169,5168,5168,5168,2018,24,209,24,148,2018,61,24,125,121,118,24,24,209,61,31,31,0,24,7,7,7,7,7,6,2,2,2,4,4,0,2024-01-04 20:34:00,0
5161,5162,5162,5162,2019,24,201,24,145,2019,56,24,119,118,118,24,24,201,56,28,28,0,24,4,4,4,4,3,0,2,2,2,1,1,1,2024-01-04 20:36:00,0
5196,5196,5196,5196,2027,24,226,24,145,2027,81,24,122,120,119,24,24,226,81,28,28,0,24,4,4,4,4,4,2,2,2,2,2,2,0,2024-01-04 20:38:00,0
5151,5151,5151,5151,2012,24,213,24,144,2012,69,24,122,118,117,24,24,213,69,28,28,0,24,4,4,4,4,3,2,2,2,2,4,4,1,2024-01-04 20:40:00,0
5133,5154,5133,5133,2014,22,191,22,148,2014,43,22,122,121,119,22,22,191,43,31,31,0,22,7,7,7,7,7,4,2,2,2,1,1,0,2024-01-04 20:42:00,0
5169,5169,5169,5169,2010,24,225,24,145,2010,80,24,124,119,117,24,24,225,80,28,28,0,24,4,4,4,4,4,4,2,2,2,5,5,0,2024-01-04 20:44:00,0
5157,5157,5157,5157,2012,24,205,24,143,2012,62,24,125,121,118,24,24,205,62,27,27,0,24,3,3,3,3,3,6,2,2,2,4,4,0,2024-01-04 20:46:00,1
5183,5183,5183,5183,2024,24,216,24,149,2024,67,24,125,121,118,24,24,216,67,32,32,0,24,8,8,8,8,8,6,2,2,2,4,4,0,2024-01-04 20:48:00,0
5161,5161,5161,5161,2020,24,247,24,145,2020,102,24,124,120,118,24,24,247,51,28,28,10,24,4,4,3,3,3,4,2,2,2,4,4,0,2024-01-04 20:50:00,52
5172,5171,5171,5171,2024,24,200,24,145,2024,55,24,130,122,118,24,24,200,55,28,28,0,24,4,4,4,4,3,8,2,2,2,8,8,1,2024-01-04 20:52:00,0
5176,5178,5176,5176,2013,24,230,24,144,2013,86,24,122,120,117,24,24,230,86,28,28,0,24,4,4,4,4,4,6,2,2,2,2,2,0,2024-01-04 20:54:00,0
5202,5203,5203,5203,2030,24,221,24,149,2030,72,24,122,121,119,24,24,221,72,31,31,0,24,7,7,7,7,6,4,2,2,2,1,1,1,2024-01-04 20:56:00,0
5198,5197,5197,5197,2026,24,228,24,145,2026,83,24,122,119,119,24,24,228,83,28,28,0,24,4,4,4,4,4,0,2,2,2,3,3,0,2024-01-04 20:58:00,0
5161,5161,5161,5161,2016,24,210,24,145,2016,65,24,125,120,117,24,24,210,65,28,28,0,24,4,4,4,4,4,6,2,2,2,5,5,0,2024-01-04 21:00:00,0
5168,5167,5169,5169,2017,24,209,24,148,2017,61,24,122,120,118,24,24,209,61,31,31,0,24,7,7,7,7,7,4,2,2,2,2,2,0,2024-01-04 21:02:00,0
5160,5160,5160,5160,2021,24,197,24,145,2021,52,24,121,119,118,24,24,197,52,28,28,0,24,4,4,4,4,4,2,2,2,2,2,2,0,2024-01-04 21:04:00,0
5166,5185,5166,5166,2023,22,201,22,144,2023,57,22,120,119,118,22,22,201,57,27,27,0,22,3,3,3,3,3,2,2,2,2,1,1,0,2024-01-04 21:06:00,0
5194,5194,5194,5194,2031,24,211,24,145,2031,66,24,123,118,118,24,24,211,66,28,28,0,24,4,4,4,4,3,0,2,2,2,5,5,1,2024-01-04 21:08:00,0
5187,5187,5187,5187,2022,24,223,24,148,2022,75,24,123,120,118,24,24,223,75,31,31,0,24,7,7,7,7,7,4,2,2,2,3,3,0,2024-01-04 21:10:00,0
5184,5184,5184,5184,2019,24,217,24,145,2019,72,24,125,119,118,24,24,217,72,28,28,0,24,4,4,4,4,3,2,2,2,2,6,6,1,2024-01-04 21:12:00,0
5177,5176,5176,5176,2024,24,211,24,145,2024,66,24,122,119,118,24,24,211,66,28,28,0,24,4,4,4,4,4,2,2,2,2,3,3,0,2024-01-04 21:14:00,0
5172,5173,5173,5173,2026,24,195,24,145,2026,50,24,127,122,118,24,24,195,50,28,28,0,24,4,4,4,4,4,8,2,2,2,5,5,0,2024-01-04 21:16:00,0
5169,5169,5169,5169,2026,24,195,24,148,2026,47,24,123,119,118,24,24,195,47,31,31,0,24,7,7,7,7,7,2,2,2,2,4,4,0,2024-01-04 21:18:00,0
5188,5185,5185,5185,2034,24,197,24,146,2034,51,24,123,120,118,24,24,197,51,28,28,0,24,4,4,4,4,4,4,2,2,2,3,3,0,2024-01-04 21:20:00,0
5140,5143,5143,5143,2002,24,212,24,144,2002,68,24,124,118,118,24,24,212,68,28,28,0,24,4,4,4,4,3,0,2,2,2,6,6,1,2024-01-04 21:22:00,0
5149,5148,5148,5148,2014,24,214,24,147,2014,67,24,122,118,118,24,24,214,67,31,31,0,24,7,7,7,7,7,0,2,2,2,4,4,0,2024-01-04 21:24:00,0
5192,5192,5192,5192,2040,24,192,24,145,2040,47,24,122,119,118,24,24,192,47,27,27,0,24,3,3,3,3,3,2,2,2,2,3,3,0,2024-01-04 21:26:00,0
5221,5222,5222,5222,2038,24,223,24,146,2038,77,24,123,122,119,24,24,223,77,28,28,0,24,4,4,4,4,3,6,2,2,2,1,1,1,2024-01-04 21:28:00,0
5165,5164,5164,5164,2017,24,205,24,144,2017,61,24,124,119,118,24,24,205,61,28,28,0,24,4,4,4,4,4,2,2,2,2,5,5,0,2024-01-04 21:30:00,0
5185,5186,5186,5186,2028,22,212,22,149,2028,63,22,124,122,118,22,22,212,63,31,31,0,22,7,7,7,7,7,8,2,2,2,2,2,0,2024-01-04 21:32:00,0
5162,5162,5162,5162,2023,24,192,24,145,2023,47,24,124,121,118,24,24,192,47,28,28,0,24,4,4,4,4,4,6,2,2,2,3,3,0,2024-01-04 21:34:00,0
5180,5179,5179,5179,2023,24,205,24,145,2023,60,24,124,120,119,24,24,205,60,28,28,0,24,4,4,4,4,4,2,2,2,2,4,4,0,2024-01-04 21:36:00,0
5170,5171,5171,5171,2017,24,216,24,147,2017,69,24,122,120,117,24,24,216,69,31,31,0,24,7,7,7,7,6,6,2,2,2,2,2,1,2024-01-04 21:38:00,0
5191,5192,5191,5191,2031,24,205,24,146,2031,59,24,124,120,119,24,24,205,59,28,28,0,24,4,4,4,4,4,2,2,2,2,4,4,0,2024-01-04 21:40:00,0
5190,5189,5189,5189,2018,24,227,24,144,2018,83,24,125,122,119,24,24,227,83,27,27,0,24,3,3,3,3,3,6,2,2,2,3,3,0,2024-01-04 21:42:00,0
5177,5177,5177,5177,2021,24,213,24,145,2021,68,24,122,119,118,24,24,213,68,28,28,0,24,4,4,4,4,3,2,2,2,2,3,3,1,2024-01-04 21:44:00,0
5207,5208,5208,5208,2029,24,230,24,149,2029,81,24,124,122,118,24,24,230,81,32,32,0,24,8,8,8,8,8,8,2,2,2,2,2,0,2024-01-04 21:46:00,0
5110,5110,5110,5110,2002,24,187,24,143,2002,44,24,121,119,118,24,24,187,44,27,27,0,24,3,3,3,3,3,2,2,2,2,2,2,0,2024-01-04 21:48:00,0
5211,5211,5211,5211,2037,24,274,24,147,2037,127,24,119,119,118,24,24,274,76,29,29,0,24,5,5,4,4,4,2,2,2,2,0,0,0,2024-01-04 21:50:00,52
5214,5213,5213,5213,2038,24,213,24,146,2038,67,24,124,121,120,24,24,213,67,28,28,0,24,4,4,4,4,4,2,2,2,2,3,3,0,2024-01-04 21:52:00,0
5164,5164,5164,5164,2019,24,207,24,147,2019,60,24,123,120,117,24,24,207,60,31,31,0,24,7,7,7,7,6,6,2,2,2,3,3,1,2024-01-04 21:54:00,0
5190,5188,5188,5188,2025,24,214,24,146,2025,68,24,123,118,118,24,24,214,68,28,28,0,24,4,4,4,4,4,0,2,2,2,5,5,0,2024-01-04 21:56:00,0
6763,6766,6766,6766,2636,28,286,28,187,2636,99,28,161,157,155,28,28,286,99,35,35,0,28,4,4,4,4,3,4,3,3,3,4,4,1,2024-01-04 21:58:00,0
5203,5203,5203,5203,2023,24,231,24,149,2023,82,24,123,118,118,24,24,231,82,31,31,0,24,7,7,7,7,7,0,2,2,2,5,5,0,2024-01-04 22:00:00,0
5161,5159,5161,5161,2019,24,202,24,145,2019,57,24,121,120,118,24,24,202,57,28,28,0,24,4,4,4,4,4,4,2,2,2,1,1,0,2024-01-04 22:02:00,0
5173,5172,5172,5172,2024,24,202,24,144,2024,58,24,122,120,119,24,24,202,58,27,27,0,24,3,3,3,3,3,2,2,2,2,2,2,0,2024-01-04 22:04:00,0
5205,5205,5205,5205,2029,24,222,24,145,2029,77,24,122,120,119,24,24,222,77,28,28,0,24,4,4,4,4,4,2,2,2,2,2,2,0,2024-01-04 22:06:00,0
5199,5197,5197,5197,2028,24,224,24,149,2028,75,24,126,119,118,24,24,224,75,31,31,0,24,7,7,7,7,7,2,2,2,2,7,7,0,2024-01-04 22:08:00,0
5181,5184,5184,5184,2024,24,208,24,145,2024,63,24,125,121,118,24,24,208,63,28,28,0,24,4,4,4,4,3,6,2,2,2,4,4,1,2024-01-04 22:10:00,0
5153,5153,5153,5153,2013,24,204,24,144,2013,60,24,123,120,118,24,24,204,60,28,28,0,24,4,4,4,4,4,4,2,2,2,3,3,0,2024-01-04 22:12:00,0
5182,5181,5181,5181,2028,24,205,24,148,2028,57,24,125,122,118,24,24,205,57,31,31,0,24,7,7,7,7,6,8,2,2,2,3,3,1,2024-01-04 22:14:00,0
5181,5181,5182,5181,2023,24,206,24,145,2023,61,24,125,123,119,24,24,206,61,28,28,0,24,4,4,4,4,4,8,2,2,2,2,2,0,2024-01-04 22:16:00,0
5191,5191,5190,5191,2030,24,211,24,146,2030,65,24,121,118,118,24,24,211,65,28,28,0,24,4,4,4,4,4,0,2,2,2,3,3,0,2024-01-04 22:18:00,0
5151,5152,5152,5152,2019,24,196,24,142,2019,54,24,122,118,118,24,24,196,54,26,26,0,24,3,3,3,3,3,0,2,2,2,4,4,0,2024-01-04 22:20:00,0
5159,5158,5158,5158,2011,22,222,22,149,2011,73,22,124,119,118,22,22,222,73,32,32,0,22,8,8,8,8,8,2,2,2,2,5,5,0,2024-01-04 22:22:00,0
5159,5160,5160,5160,2016,24,204,24,144,2016,60,24,122,119,118,24,24,204,60,27,27,0,24,3,3,3,3,3,2,2,2,2,3,3,0,2024-01-04 22:24:00,0
5218,5218,5218,5218,2040,24,214,24,146,2040,68,24,124,121,119,24,24,214,68,28,28,0,24,4,4,4,4,3,4,2,2,2,3,3,1,2024-01-04 22:26:00,0
5176,5175,5175,5175,2020,24,215,24,145,2020,70,24,123,118,118,24,24,215,70,28,28,0,24,4,4,4,4,4,0,2,2,2,5,5,0,2024-01-04 22:28:00,0
5186,5187,5187,5187,2024,24,220,24,149,2024,71,24,120,118,117,24,24,220,71,31,31,0,24,7,7,7,7,6,2,2,2,2,2,2,1,2024-01-04 22:30:00,0
5189,5188,5188,5188,2030,24,210,24,145,2030,65,24,125,120,119,24,24,210,65,28,28,0,24,4,4,4,4,4,2,2,2,2,5,5,0,2024-01-04 22:32:00,0
5165,5186,5166,5166,2020,24,197,24,145,2020,52,24,124,119,118,24,24,197,52,28,28,0,24,4,4,4,4,4,2,2,2,2,5,5,0,2024-01-04 22:34:00,0
5177,5177,5177,5177,2026,24,208,24,149,2026,59,24,122,119,118,24,24,208,59,31,31,4,24,7,7,7,7,7,2,2,2,2,3,3,0,2024-01-04 22:36:00,0
5218,5218,5218,5218,2039,24,219,24,146,2039,73,24,124,122,119,24,24,219,73,28,28,0,24,4,4,4,4,4,6,2,2,2,2,2,0,2024-01-04 22:38:00,0
5209,5209,5209,5209,2034,24,220,24,144,2034,76,24,123,119,118,24,24,220,76,27,27,0,24,3,3,3,3,3,2,2,2,2,4,4,0,2024-01-04 22:40:00,0
5154,5153,5153,5153,2011,24,208,24,145,2011,63,24,125,121,119,24,24,208,63,28,28,0,24,4,4,4,4,3,4,2,2,2,4,4,1,2024-01-04 22:42:00,0
5140,5141,5141,5141,2011,24,212,24,147,2011,65,24,120,118,117,24,24,212,65,31,31,0,24,7,7,7,7,7,2,2,2,2,2,2,0,2024-01-04 22:44:00,0
5192,5191,5191,5191,2026,24,220,23,148,2026,72,23,125,121,118,23,23,220,72,30,30,0,23,5,4,4,4,3,6,2,2,2,4,4,1,2024-01-04 22:46:00,3
5172,5191,5172,5172,2021,22,211,23,145,2021,66,23,124,120,118,23,23,211,66,28,28,0,23,4,4,4,4,4,4,2,2,2,4,4,0,2024-01-04 22:48:00,0
5181,5181,5181,5181,2029,24,253,24,147,2029,106,24,121,119,118,24,24,253,55,29,29,0,24,5,5,4,4,4,2,2,2,2,2,2,0,2024-01-04 22:50:00,52
5160,5161,5161,5161,2019,24,205,24,148,2019,57,24,120,119,118,24,24,205,57,31,31,0,24,7,7,7,7,7,2,2,2,2,1,1,0,2024-01-04 22:52:00,0
5187,5187,5187,5187,2029,24,207,24,146,2029,61,24,124,119,118,24,24,207,61,28,28,0,24,4,4,4,4,4,2,2,2,2,5,5,0,2024-01-04 22:54:00,0
5194,5194,5194,5194,2027,24,212,24,145,2027,67,24,128,121,118,24,24,212,67,28,28,10,24,4,4,4,4,3,6,2,2,2,7,7,1,2024-01-04 22:56:00,0
5170,5170,5170,5170,2015,24,213,24,148,2015,65,24,126,121,119,24,24,213,65,31,31,0,24,7,7,7,7,7,4,2,2,2,5,5,0,2024-01-04 22:58:00,0
5174,5174,5174,5174,2021,24,203,24,144,2021,59,24,126,120,118,24,24,203,59,27,27,0,24,3,3,3,3,3,4,2,2,2,6,6,0,2024-01-04 23:00:00,0
5162,5160,5162,5162,2010,24,216,24,145,2010,71,24,124,121,117,24,24,216,71,28,28,0,24,4,4,4,4,3,8,2,2,2,3,3,1,2024-01-04 23:02:00,0
5188,5187,5187,5187,2024,24,216,24,145,2024,71,24,124,120,119,24,24,216,71,28,28,0,24,4,4,4,4,4,2,2,2,2,4,4,0,2024-01-04 23:04:00,0
5202,5202,5202,5202,2028,24,221,24,149,2028,72,24,127,123,120,24,24,221,72,31,31,0,24,7,7,7,7,7,6,2,2,2,4,4,0,2024-01-04 23:06:00,0
5153,5154,5154,5154,2016,24,203,24,144,2016,59,24,126,120,117,24,24,203,59,28,28,0,24,4,4,4,4,4,6,2,2,2,6,6,0,2024-01-04 23:08:00,0
5205,5204,5204,5204,2030,24,218,24,146,2030,72,24,124,122,118,24,24,218,72,28,28,0,24,4,4,4,4,4,8,2,2,2,2,2,0,2024-01-04 23:10:00,0
5206,5206,5206,5206,2028,22,227,22,148,2028,79,22,126,123,118,22,22,227,79,31,31,0,22,7,7,7,7,6,10,2,2,2,3,3,1,2024-01-04 23:12:00,0
5198,5198,5198,5198,2025,24,226,24,145,2025,81,24,123,120,118,24,24,226,81,28,28,0,24,4,4,4,4,4,4,2,2,2,3,3,0,2024-01-04 23:14:00,0
5170,5170,5170,5170,2018,24,209,24,144,2018,65,24,122,118,118,24,24,209,65,27,27,0,24,3,3,3,3,3,0,2,2,2,4,4,0,2024-01-04 23:16:00,0
5194,5195,5195,5195,2035,24,208,24,146,2035,62,24,120,119,119,24,24,208,62,28,28,0,24,4,4,4,4,3,0,2,2,2,1,1,1,2024-01-04 23:18:00,0
5173,5173,5173,5173,2029,24,199,24,149,2029,50,24,120,118,118,24,24,199,50,32,32,0,24,8,8,8,8,8,0,2,2,2,2,2,0,2024-01-04 23:20:00,0
5149,5148,5148,5148,2015,24,195,24,144,2015,51,24,119,119,118,24,24,195,51,27,27,0,24,3,3,3,3,3,2,2,2,2,0,0,0,2024-01-04 23:22:00,0
5201,5202,5202,5202,2034,24,215,24,145,2034,70,24,123,120,119,24,24,215,70,28,28,0,24,4,4,4,4,4,2,2,2,2,3,3,0,2024-01-04 23:24:00,0
5172,5172,5172,5172,2023,24,202,24,145,2023,57,24,122,120,118,24,24,202,57,28,28,0,24,4,4,4,4,4,4,2,2,2,2,2,0,2024-01-04 23:26:00,0
5177,5176,5176,5176,2019,24,214,24,148,2019,66,24,124,122,118,24,24,214,66,31,31,0,24,7,7,7,7,6,8,2,2,2,2,2,1,2024-01-04 23:28:00,0
5144,5144,5144,5144,2015,24,204,24,145,2015,59,24,120,119,118,24,24,204,59,28,28,0,24,4,4,4,4,4,2,2,2,2,1,1,0,2024-01-04 23:30:00,0
5178,5179,5179,5179,2017,24,220,24,145,2017,75,24,120,119,118,24,24,220,75,28,28,0,24,4,4,4,4,3,2,2,2,2,1,1,1,2024-01-04 23:32:00,0
5183,5183,5183,5183,2022,24,216,24,148,2022,68,24,121,118,118,24,24,216,68,31,31,0,24,7,7,7,7,7,0,2,2,2,3,3,0,2024-01-04 23:34:00,0
5200,5200,5200,5200,2032,24,216,24,145,2032,71,24,124,122,118,24,24,216,71,28,28,0,24,4,4,4,4,4,8,2,2,2,2,2,0,2024-01-04 23:36:00,0
5145,5145,5145,5145,2016,22,194,22,144,2016,50,22,118,117,117,22,22,194,50,27,27,0,22,3,3,3,3,3,0,2,2,2,1,1,0,2024-01-04 23:38:00,0
5167,5167,5167,5167,2027,24,191,24,145,2027,46,24,125,121,118,24,24,191,46,28,28,0,24,4,4,4,4,4,6,2,2,2,4,4,0,2024-01-04 23:40:00,0
5173,5175,5173,5173,2017,24,217,24,148,2017,69,24,123,120,118,24,24,217,69,31,31,0,24,7,7,7,7,7,4,2,2,2,3,3,0,2024-01-04 23:42:00,0
5204,5204,5204,5204,2032,24,220,24,145,2032,75,24,123,119,119,24,24,220,75,28,28,0,24,4,4,4,4,3,0,2,2,2,4,4,1,2024-01-04 23:44:00,0
5188,5188,5188,5188,2031,24,202,24,145,2031,57,24,124,120,118,24,24,202,57,28,28,0,24,4,4,4,4,4,4,2,2,2,4,4,0,2024-01-04 23:46:00,0
5193,5191,5191,5191,2027,24,223,24,148,2027,75,24,122,120,119,24,24,223,75,31,31,0,24,7,7,7,7,6,2,2,2,2,2,2,1,2024-01-04 23:48:00,0
5188,5188,5188,5188,2029,24,263,24,147,2029,116,24,123,120,119,24,24,263,65,29,29,0,24,5,5,4,4,4,2,2,2,2,3,3,0,2024-01-04 23:50:00,52
5189,5191,5191,5191,2029,24,207,24,145,2029,62,24,120,118,118,24,24,207,62,28,28,0,24,4,4,4,4,4,0,2,2,2,2,2,0,2024-01-04 23:52:00,0
5128,5126,5126,5126,2007,24,199,24,143,2007,56,24,121,118,117,24,24,199,56,27,27,0,24,3,3,3,3,3,2,2,2,2,3,3,0,2024-01-04 23:54:00,0
5204,5205,5205,5205,2029,24,225,24,150,2029,75,24,125,120,119,24,24,225,75,32,32,0,24,8,8,8,8,8,2,2,2,2,5,5,0,2024-01-04 23:56:00,0
5194,5196,5195,5195,2026,24,216,24,144,2026,72,24,126,120,119,24,24,216,72,27,27,0,24,3,3,3,3,3,2,2,2,2,6,6,0,2024-01-04 23:58:00,0
5197,5197,5197,5197,2034,24,204,24,145,2034,59,24,123,119,118,24,24,204,59,28,28,0,24,4,4,4,4,3,2,2,2,2,4,4,1,2024-01-05 00:00:00,0
5170,5169,5169,5169,2020,24,204,24,146,2020,58,24,125,122,118,24,24,204,58,28,28,0,24,4,4,4,4,4,8,2,2,2,3,3,0,2024-01-05 00:02:00,0
5174,5175,5175,5175,2025,22,207,22,148,2025,59,22,123,121,118,22,22,207,59,31,31,0,22,7,7,7,7,6,6,2,2,2,2,2,1,2024-01-05 00:04:00,0
5192,5191,5191,5191,2028,24,218,24,145,2028,73,24,126,124,119,24,24,218,73,28,28,0,24,4,4,4,4,4,10,2,2,2,2,2,0,2024-01-05 00:06:00,0
5182,5183,5183,5183,2024,24,216,24,145,2024,71,24,122,118,118,24,24,216,71,28,28,0,24,4,4,4,4,4,0,2,2,2,4,4,0,2024-01-05 00:08:00,0
5173,5173,5173,5173,2028,24,200,24,148,2028,52,24,123,118,118,24,24,200,52,31,31,0,24,7,7,7,7,7,0,2,2,2,5,5,0,2024-01-05 00:10:00,0
5201,5201,5201,5201,2027,24,223,24,145,2027,78,24,124,119,118,24,24,223,78,28,28,0,24,4,4,4,4,4,2,2,2,2,5,5,0,2024-01-05 00:12:00,0
5175,5175,5175,5175,2019,24,218,24,144,2019,74,24,124,120,118,24,24,218,74,27,27,0,24,3,3,3,3,3,4,2,2,2,4,4,0,2024-01-05 00:14:00,0
5166,5165,5165,5165,2023,24,201,24,145,2023,56,24,120,119,118,24,24,201,56,28,28,0,24,4,4,4,4,3,2,2,2,2,1,1,1,2024-01-05 00:16:00,0
5137,5138,5138,5138,2007,24,215,24,147,2007,68,24,121,118,118,24,24,215,68,31,31,0,24,7,7,7,7,7,0,2,2,2,3,3,0,2024-01-05 00:18:00,0
5143,5142,5143,5143,2021,24,181,24,145,2021,36,24,121,119,118,24,24,181,36,28,28,0,24,4,4,4,4,3,2,2,2,2,2,2,1,2024-01-05 00:20:00,0
5148,5149,5148,5148,2017,24,196,24,145,2017,51,24,119,119,118,24,24,196,51,28,28,0,24,4,4,4,4,4,2,2,2,2,0,0,0,2024-01-05 00:22:00,0
5179,5179,5179,5179,2033,24,196,24,148,2033,48,24,126,119,118,24,24,196,48,31,31,0,24,7,7,7,7,7,2,2,2,2,7,7,0,2024-01-05 00:24:00,0
5226,5225,5225,5225,2038,24,224,24,146,2038,78,24,126,122,119,24,24,224,78,28,28,0,24,4,4,4,4,4,6,2,2,2,4,4,0,2024-01-05 00:26:00,0
5202,5203,5203,5203,2033,24,215,24,146,2033,69,24,123,119,119,24,24,215,69,28,28,0,24,4,4,4,4,4,0,2,2,2,4,4,0,2024-01-05 00:28:00,0
5173,5172,5172,5172,2020,22,212,22,145,2020,67,22,126,120,118,22,22,212,67,28,28,0,22,4,4,4,4,3,4,2,2,2,6,6,1,2024-01-05 00:30:00,0
5172,5174,5173,5173,2017,24,221,24,147,2017,74,24,122,119,117,24,24,221,74,31,31,0,24,7,7,7,7,7,4,2,2,2,3,3,0,2024-01-05 00:32:00,0
5168,5167,5167,5167,2025,24,202,24,144,2025,58,24,122,122,118,24,24,202,58,27,27,0,24,3,3,3,3,3,8,2,2,2,0,0,0,2024-01-05 00:34:00,0
5186,5185,5185,5185,2023,24,216,24,145,2023,71,24,123,120,118,24,24,216,71,28,28,0,24,4,4,4,4,3,4,2,2,2,3,3,1,2024-01-05 00:36:00,0
5208,5210,5210,5210,2039,24,210,24,146,2039,64,24,124,122,120,24,24,210,64,28,28,0,24,4,4,4,4,4,4,2,2,2,2,2,0,2024-01-05 00:38:00,0
5143,5142,5142,5142,2018,24,199,24,147,2018,52,24,124,120,117,24,24,199,52,31,31,0,24,7,7,7,7,7,6,2,2,2,4,4,0,2024-01-05 00:40:00,0
5185,5186,5186,5186,2026,24,218,24,147,2026,71,24,122,119,118,24,24,218,71,29,29,0,24,4,4,4,4,4,2,2,2,2,3,3,0,2024-01-05 00:42:00,2
5183,5182,5182,5182,2020,24,217,24,144,2020,73,24,126,120,118,24,24,217,73,28,28,0,24,4,4,4,4,4,4,2,2,2,6,6,0,2024-01-05 00:44:00,0
5203,5204,5204,5204,2023,24,238,24,148,2023,90,24,125,121,118,24,24,238,90,31,31,0,24,7,7,7,7,6,6,2,2,2,4,4,1,2024-01-05 00:46:00,0
5198,5197,5197,5197,2029,24,217,24,146,2029,71,24,125,120,118,24,24,217,71,28,28,0,24,4,4,4,4,4,4,2,2,2,5,5,0,2024-01-05 00:48:00,0
5193,5214,5193,5193,2030,24,261,24,145,2030,116,24,121,119,118,24,24,261,65,28,28,0,24,4,4,3,3,3,2,2,2,2,2,2,0,2024-01-05 00:50:00,52
5182,5183,5183,5183,2032,24,200,24,146,2032,54,24,122,119,119,24,24,200,54,28,28,0,24,4,4,4,4,3,0,2,2,2,3,3,1,2024-01-05 00:52:00,0
5187,5187,5187,5187,2029,24,209,24,149,2029,60,24,126,120,118,24,24,209,60,32,32,0,24,8,8,8,8,8,4,2,2,2,6,6,0,2024-01-05 00:54:00,0
5172,5171,5171,5171,2019,24,207,23,144,2019,63,23,125,122,118,23,23,207,63,27,27,0,23,3,3,3,3,3,8,2,2,2,3,3,0,2024-01-05 00:56:00,0
5200,5200,5200,5200,2035,22,210,23,146,2035,64,23,125,122,119,23,23,210,64,28,28,0,23,4,4,4,4,4,6,2,2,2,3,3,0,2024-01-05 00:58:00,0
5178,5178,5178,5178,2027,24,205,24,148,2027,57,24,122,119,118,24,24,205,57,31,31,0,24,7,7,7,7,7,2,2,2,2,3,3,0,2024-01-05 01:00:00,0
5181,5181,5181,5181,2021,24,313,24,145,2021,168,24,123,122,119,24,24,313,168,28,28,0,24,4,4,4,4,3,6,2,2,2,1,1,1,2024-01-05 01:02:00,0
5147,5148,5148,5148,2014,24,201,24,144,2014,57,24,122,120,117,24,24,201,57,27,27,0,24,4,4,4,4,4,6,2,2,2,2,2,0,2024-01-05 01:04:00,0
5161,5180,5160,5160,2020,24,205,24,145,2020,60,24,120,118,118,24,24,205,60,28,28,4,24,4,4,4,4,3,0,2,2,2,2,2,1,2024-01-05 01:06:00,0
5164,5165,5165,5165,2018,24,200,24,147,2018,53,24,129,121,118,24,24,200,53,31,31,0,24,7,7,7,7,7,6,2,2,2,8,8,0,2024-01-05 01:08:00,0
5191,5192,5191,5191,2029,24,218,24,145,2029,73,24,125,121,118,24,24,218,73,28,28,0,24,4,4,4,4,4,6,2,2,2,4,4,0,2024-01-05 01:10:00,0
5184,5184,5184,5184,2024,24,211,24,144,2024,67,24,123,120,118,24,24,211,67,27,27,0,24,3,3,3,3,3,4,2,2,2,3,3,0,2024-01-05 01:12:00,0
5165,5165,5165,5165,2021,24,199,24,145,2021,54,24,125,121,118,24,24,199,54,28,28,0,24,4,4,4,4,4,6,2,2,2,4,4,0,2024-01-05 01:14:00,0
5189,5189,5189,5189,2026,24,216,24,148,2026,68,24,123,120,118,24,24,216,68,31,31,0,24,7,7,7,7,7,4,2,2,2,3,3,0,2024-01-05 01:16:00,0
5173,5172,5172,5172,2028,24,202,24,145,2028,57,24,123,119,118,24,24,202,57,28,28,0,24,4,4,4,4,3,2,2,2,2,4,4,1,2024-01-05 01:18:00,0
5181,5179,5179,5179,2021,24,218,24,145,2021,73,24,122,122,119,24,24,218,73,28,28,0,24,4,4,4,4,4,6,2,2,2,0,0,0,2024-01-05 01:20:00,0
5187,5190,5190,5190,2026,23,222,23,148,2026,74,23,126,124,119,23,23,222,74,31,31,0,23,7,7,7,7,6,10,2,2,2,2,2,1,2024-01-05 01:22:00,0
5169,5170,5169,5169,2028,23,193,23,145,2028,48,23,121,119,118,23,23,193,48,28,28,0,23,4,4,4,4,4,2,2,2,2,2,2,0,2024-01-05 01:24:00,0
5140,5140,5140,5140,2006,24,216,24,144,2006,72,24,123,119,117,24,24,216,72,28,28,0,24,4,4,4,4,4,4,2,2,2,4,4,0,2024-01-05 01:26:00,0
5179,5178,5178,5178,2014,24,231,24,143,2014,88,24,121,118,117,24,24,231,88,27,27,0,24,3,3,3,3,3,2,2,2,2,3,3,0,2024-01-05 01:28:00,0
5203,5203,5203,5203,2034,24,219,24,150,2034,69,24,124,119,118,24,24,219,69,32,32,0,24,8,8,8,8,8,2,2,2,2,5,5,0,2024-01-05 01:30:00,0
5180,5180,5180,5180,2023,24,214,24,144,2023,70,24,121,119,118,24,24,214,70,27,27,0,24,3,3,3,3,3,2,2,2,2,2,2,0,2024-01-05 01:32:00,0
5192,5193,5193,5193,2026,24,218,24,145,2026,73,24,121,120,118,24,24,218,73,28,28,0,24,4,4,4,4,3,4,2,2,2,1,1,1,2024-01-05 01:34:00,0
5192,5191,5191,5191,2027,24,216,24,148,2027,68,24,126,124,119,24,24,216,68,31,31,0,24,7,7,7,7,7,10,2,2,2,2,2,0,2024-01-05 01:36:00,0
5198,5197,5197,5197,2037,24,203,24,146,2037,57,24,122,119,119,24,24,203,57,28,28,0,24,4,4,4,4,3,0,2,2,2,3,3,1,2024-01-05 01:38:00,0
5182,5183,5183,5183,2024,24,215,24,144,2024,71,24,122,120,118,24,24,215,71,28,28,0,24,4,4,4,4,4,4,2,2,2,2,2,0,2024-01-05 01:40:00,0
5166,5167,5167,5167,2014,24,212,24,145,2014,67,24,124,120,117,24,24,212,67,28,28,0,24,4,4,4,4,4,6,2,2,2,4,4,0,2024-01-05 01:42:00,0
5173,5172,5172,5172,2024,24,204,24,148,2024,56,24,125,120,118,24,24,204,56,31,31,0,24,7,7,7,7,7,4,2,2,2,5,5,0,2024-01-05 01:44:00,0
5183,5184,5184,5184,2021,24,219,24,145,2021,74,24,125,120,118,24,24,219,74,28,28,0,24,4,4,4,4,4,4,2,2,2,5,5,0,2024-01-05 01:46:00,0
5190,5189,5189,5189,2022,23,226,22,144,2022,82,22,121,119,118,22,22,226,82,27,27,0,22,3,3,3,3,3,2,2,2,2,2,2,0,2024-01-05 01:48:00,0
5141,5142,5142,5142,2005,23,268,24,145,2005,123,24,124,120,117,24,24,268,72,29,29,0,24,5,5,4,4,3,6,2,2,2,4,4,1,2024-01-05 01:50:00,52
5182,5182,5182,5182,2032,24,201,24,148,2032,53,24,123,120,118,24,24,201,53,31,31,0,24,7,7,7,7,7,4,2,2,2,3,3,0,2024-01-05 01:52:00,0
5192,5190,5190,5190,2030,24,215,24,145,2030,70,24,121,118,118,24,24,215,70,28,28,0,24,4,4,4,4,3,0,2,2,2,3,3,1,2024-01-05 01:54:00,0
5200,5201,5201,5201,2032,24,216,24,146,2032,70,24,125,121,119,24,24,216,70,28,28,0,24,4,4,4,4,4,4,2,2,2,4,4,0,2024-01-05 01:56:00,0
5170,5171,5171,5171,2017,24,223,24,148,2017,75,24,122,119,117,24,24,223,75,31,31,0,24,7,7,7,7,7,4,2,2,2,3,3,0,2024-01-05 01:58:00,0
5181,5180,5180,5180,2030,24,199,24,145,2030,54,24,124,119,118,24,24,199,54,28,28,0,24,4,4,4,4,4,2,2,2,2,5,5,0,2024-01-05 02:00:00,0
5174,5174,5175,5175,2012,24,225,24,145,2012,80,24,126,123,118,24,24,225,80,28,28,0,24,4,4,4,4,4,10,2,2,2,3,3,0,2024-01-05 02:02:00,0
5161,5160,5160,5160,2030,24,183,24,145,2030,38,24,124,118,118,24,24,183,38,28,28,0,24,4,4,4,4,3,0,2,2,2,6,6,1,2024-01-05 02:04:00,0
5175,5176,5176,5176,2026,24,213,24,149,2026,64,24,122,119,118,24,24,213,64,32,32,0,24,7,7,7,7,7,2,2,2,2,3,3,0,2024-01-05 02:06:00,3
5197,5197,5197,5197,2032,24,215,24,146,2032,69,24,122,121,118,24,24,215,69,28,28,0,24,3,3,3,3,3,6,2,2,2,1,1,0,2024-01-05 02:08:00,2
5190,5208,5189,5189,2033,24,202,24,145,2033,57,24,120,119,119,24,24,202,57,28,28,0,24,4,4,4,4,3,0,2,2,2,1,1,1,2024-01-05 02:10:00,0
5179,5177,5177,5177,2018,23,226,23,145,2018,81,23,121,121,118,23,23,226,81,28,28,0,23,4,4,4,4,4,6,2,2,2,0,0,0,2024-01-05 02:12:00,0
5162,5165,5165,5165,2020,23,215,23,148,2020,67,23,122,120,118,23,23,215,67,31,31,0,23,7,7,7,7,7,4,2,2,2,2,2,0,2024-01-05 02:14:00,0
5187,5187,5187,5187,2027,24,212,24,145,2027,67,24,125,120,118,24,24,212,67,28,28,0,24,4,4,4,4,4,4,2,2,2,5,5,0,2024-01-05 02:16:00,0
5178,5177,5177,5177,2028,24,207,24,145,2028,62,24,121,119,119,24,24,207,62,28,28,0,24,4,4,4,4,4,0,2,2,2,2,2,0,2024-01-05 02:18:00,0
5177,5177,5177,5177,2033,24,192,24,149,2033,43,24,127,119,118,24,24,192,43,31,31,0,24,7,7,7,7,6,2,2,2,2,8,8,1,2024-01-05 02:20:00,0
5137,5138,5138,5138,2005,24,201,24,144,2005,57,24,123,120,119,24,24,201,57,28,28,0,24,4,4,4,4,4,2,2,2,2,3,3,0,2024-01-05 02:22:00,0
5205,5204,5204,5204,2034,24,217,24,145,2034,72,24,122,120,118,24,24,217,72,27,27,0,24,3,3,3,3,3,4,2,2,2,2,2,0,2024-01-05 02:24:00,0
5185,5186,5186,5186,2028,24,211,24,145,2028,66,24,124,122,120,24,24,211,66,28,28,0,24,4,4,4,4,3,4,2,2,2,2,2,1,2024-01-05 02:26:00,0
5161,5161,5161,5161,2017,24,206,24,149,2017,57,24,126,121,118,24,24,206,57,32,32,0,24,8,8,8,8,8,6,2,2,2,5,5,0,2024-01-05 02:28:00,0
5160,5160,5160,5160,2021,24,203,24,144,2021,59,24,120,119,118,24,24,203,59,27,27,0,24,3,3,3,3,3,2,2,2,2,1,1,0,2024-01-05 02:30:00,0
5173,5173,5173,5173,2022,24,208,24,145,2022,63,24,121,120,119,24,24,208,63,28,28,0,24,4,4,4,4,4,2,2,2,2,1,1,0,2024-01-05 02:32:00,0
5175,5175,5175,5175,2018,24,220,24,147,2018,73,24,123,121,118,24,24,220,73,31,31,0,24,7,7,7,7,7,6,2,2,2,2,2,0,2024-01-05 02:34:00,0
5170,5169,5169,5169,2021,24,208,24,145,2021,63,24,124,121,118,24,24,208,63,28,28,0,24,4,4,4,4,3,6,2,2,2,3,3,1,2024-01-05 02:36:00,0
5138,5138,5138,5138,2015,22,189,22,145,2015,44,22,126,124,117,22,22,189,44,28,28,0,22,4,4,4,4,4,14,2,2,2,2,2,0,2024-01-05 02:38:00,0
5189,5190,5190,5190,2024,24,221,24,145,2024,76,24,121,121,119,24,24,221,76,28,28,0,24,4,4,4,4,3,4,2,2,2,0,0,1,2024-01-05 02:40:00,0
5155,5154,5154,5154,2010,24,211,24,147,2010,64,24,125,122,119,24,24,211,64,31,31,0,24,7,7,7,7,7,6,2,2,2,3,3,0,2024-01-05 02:42:00,0
5183,5184,5184,5184,2026,24,211,24,146,2026,65,24,121,118,118,24,24,211,65,28,28,0,24,4,4,4,4,4,0,2,2,2,3,3,0,2024-01-05 02:44:00,0
5184,5184,5184,5184,2024,24,214,24,143,2024,71,24,125,121,118,24,24,214,71,27,27,0,24,3,3,3,3,3,6,2,2,2,4,4,0,2024-01-05 02:46:00,0
5161,5160,5160,5160,2018,24,194,24,145,2018,49,24,124,120,118,24,24,194,49,28,28,0,24,4,4,4,4,4,4,2,2,2,4,4,0,2024-01-05 02:48:00,0
5195,5196,5196,5196,2030,24,219,24,148,2030,71,24,123,121,118,24,24,219,71,31,31,0,24,7,7,7,7,7,6,2,2,2,2,2,0,2024-01-05 02:50:00,0
5180,5179,5179,5179,2020,24,216,24,145,2020,71,24,122,119,118,24,24,216,71,28,28,0,24,4,4,4,4,3,2,2,2,2,3,3,1,2024-01-05 02:52:00,0
5180,5181,5181,5181,2021,24,212,24,145,2021,67,24,123,120,118,24,24,212,67,28,28,0,24,4,4,4,4,4,4,2,2,2,3,3,0,2024-01-05 02:54:00,0
5176,5194,5175,5175,2029,24,202,24,148,2029,54,24,121,119,118,24,24,202,54,31,31,0,24,7,7,7,7,6,2,2,2,2,2,2,1,2024-01-05 02:56:00,0
5176,5177,5177,5177,2017,24,217,24,145,2017,72,24,123,120,119,24,24,217,72,28,28,0,24,4,4,4,4,4,2,2,2,2,3,3,0,2024-01-05 02:58:00,0
5122,5122,5122,5122,2006,24,201,24,144,2006,57,24,122,119,118,24,24,201,57,28,28,0,24,4,4,4,4,4,2,2,2,2,3,3,0,2024-01-05 03:00:00,0
5158,5158,5158,5158,2006,23,221,23,144,2006,77,23,123,118,117,23,23,221,77,27,27,0,23,3,3,3,3,3,2,2,2,2,5,5,0,2024-01-05 03:02:00,0
5198,5197,5197,5197,2033,23,315,23,149,2033,166,23,126,121,119,23,23,315,166,32,32,0,23,8,8,8,8,8,4,2,2,2,5,5,0,2024-01-05 03:04:00,0
5198,5198,5198,5198,2028,24,221,24,145,2028,76,24,119,118,118,24,24,221,76,27,27,0,24,3,3,3,3,3,0,2,2,2,1,1,0,2024-01-05 03:06:00,0
5170,5171,5171,5171,2025,24,204,24,144,2025,60,24,121,118,117,24,24,204,60,28,28,0,24,4,4,4,4,3,2,2,2,2,3,3,1,2024-01-05 03:08:00,0
5193,5192,5192,5192,2025,24,223,24,148,2025,75,24,125,119,118,24,24,223,75,31,31,0,24,7,7,7,7,7,2,2,2,2,6,6,0,2024-01-05 03:10:00,0
5173,5174,5174,5174,2025,24,202,24,146,2025,56,24,121,120,118,24,24,202,56,28,28,0,24,4,4,4,4,3,4,2,2,2,1,1,1,2024-01-05 03:12:00,0
5175,5175,5175,5175,2032,24,195,24,145,2032,50,24,123,120,118,24,24,195,50,28,28,0,24,4,4,4,4,4,4,2,2,2,3,3,0,2024-01-05 03:14:00,0
5190,5190,5190,5190,2039,24,197,24,146,2039,51,24,122,121,119,24,24,197,51,28,28,0,24,4,4,4,4,4,4,2,2,2,1,1,0,2024-01-05 03:16:00,0
5161,5160,5160,5160,2024,24,195,24,148,2024,47,24,122,120,118,24,24,195,47,31,31,0,24,7,7,7,7,7,4,2,2,2,2,2,0,2024-01-05 03:18:00,0
5161,5162,5162,5162,2028,24,184,24,145,2028,39,24,120,118,118,24,24,184,39,28,28,0,24,4,4,4,4,4,0,2,2,2,2,2,0,2024-01-05 03:20:00,0
5126,5146,5126,5126,2008,24,189,24,144,2008,45,24,120,118,117,24,24,189,45,28,28,0,24,4,4,4,4,3,2,2,2,2,2,2,1,2024-01-05 03:22:00,0
5152,5151,5151,5151,2014,24,210,24,144,2014,66,24,121,119,119,24,24,210,66,27,27,0,24,3,3,3,3,3,0,2,2,2,2,2,0,2024-01-05 03:24:00,0
5162,5161,5161,5161,2013,24,211,24,147,2013,64,24,128,122,119,24,24,211,64,31,31,0,24,7,7,7,7,7,6,2,2,2,6,6,0,2024-01-05 03:26:00,0
5192,5194,5194,5194,2030,23,207,23,146,2030,61,23,128,123,120,23,23,207,61,28,28,0,23,4,4,4,4,3,6,2,2,2,5,5,1,2024-01-05 03:28:00,0
5192,5192,5192,5192,2036,23,204,23,145,2036,59,23,120,119,119,23,23,204,59,28,28,0,23,4,4,4,4,4,0,2,2,2,1,1,0,2024-01-05 03:30:00,0
5165,5165,5165,5165,2020,24,205,24,148,2020,57,24,124,120,118,24,24,205,57,31,31,0,24,7,7,7,7,7,4,2,2,2,4,4,0,2024-01-05 03:32:00,0
5172,5171,5171,5171,2028,24,203,24,145,2028,58,24,120,119,118,24,24,203,58,28,28,0,24,4,4,4,4,4,2,2,2,2,1,1,0,2024-01-05 03:34:00,0
5168,5168,5168,5168,2021,24,199,24,145,2021,54,24,125,118,117,24,24,199,54,28,28,0,24,4,4,4,4,4,2,2,2,2,7,7,0,2024-01-05 03:36:00,0
5177,5177,5177,5177,2021,24,212,24,145,2021,67,24,126,119,119,24,24,212,67,28,28,0,24,4,4,4,4,3,0,2,2,2,7,7,1,2024-01-05 03:38:00,0
5183,5183,5183,5183,2022,24,221,24,148,2022,73,24,118,118,118,24,24,221,73,31,31,0,24,7,7,7,7,7,0,2,2,2,0,0,0,2024-01-05 03:40:00,0
5191,5192,5192,5192,2024,24,224,24,145,2024,79,24,121,119,118,24,24,224,79,27,27,0,24,3,3,3,3,3,2,2,2,2,2,2,0,2024-01-05 03:42:00,0
5189,5189,5189,5189,2029,24,216,24,145,2029,71,24,121,119,118,24,24,216,71,28,28,0,24,4,4,4,4,3,2,2,2,2,2,2,1,2024-01-05 03:44:00,0
5215,5234,5215,5215,2038,24,226,24,150,2038,76,24,125,121,119,24,24,226,76,32,32,0,24,8,8,8,8,8,4,2,2,2,4,4,0,2024-01-05 03:46:00,0
5199,5199,5199,5199,2029,24,216,24,144,2029,72,24,123,120,118,24,24,216,72,27,27,0,24,3,3,3,3,3,4,2,2,2,3,3,0,2024-01-05 03:48:00,0
5148,5147,5147,5147,2007,24,273,24,144,2007,129,24,120,118,117,24,24,273,78,28,28,0,24,5,5,4,4,4,2,2,2,2,2,2,0,2024-01-05 03:50:00,52
5184,5186,5185,5185,2019,24,221,24,145,2019,76,24,126,122,118,24,24,221,76,28,28,0,24,4,4,4,4,4,8,2,2,2,4,4,0,2024-01-05 03:52:00,0
5187,5187,5187,5187,2026,22,219,22,148,2026,71,22,125,119,119,22,22,219,71,31,31,0,22,7,7,7,7,6,0,2,2,2,6,6,1,2024-01-05 03:54:00,0
5163,5161,5161,5161,2018,24,202,24,145,2018,57,24,123,121,118,24,24,202,57,28,28,0,24,4,4,4,4,4,6,2,2,2,2,2,0,2024-01-05 03:56:00,0
5178,5179,5179,5179,2026,24,207,24,145,2026,62,24,121,118,117,24,24,207,62,28,28,0,24,4,4,4,4,3,2,2,2,2,3,3,1,2024-01-05 03:58:00,0
5191,5193,5192,5192,2026,24,215,24,144,2026,71,24,127,121,119,24,24,215,71,27,27,0,24,3,3,3,3,3,4,2,2,2,6,6,0,2024-01-05 04:00:00,0
5193,5212,5193,5193,2017,24,347,24,154,2017,193,24,127,121,119,24,24,347,193,37,37,0,24,8,8,8,8,8,4,2,2,2,6,6,0,2024-01-05 04:02:00,13
5179,5179,5179,5179,2016,24,234,24,144,2016,90,24,119,117,117,24,24,234,90,27,27,0,24,3,3,3,3,3,0,2,2,2,2,2,0,2024-01-05 04:04:00,0
5226,5225,5225,5225,2034,24,235,24,145,2034,90,24,128,121,118,24,24,235,90,28,28,0,24,4,4,4,4,4,6,2,2,2,7,7,0,2024-01-05 04:06:00,0
5164,5164,5164,5164,2020,24,210,24,148,2020,62,24,123,118,118,24,24,210,62,31,31,0,24,7,7,7,7,7,0,2,2,2,5,5,0,2024-01-05 04:08:00,0
5177,5178,5178,5178,2023,24,210,24,146,2023,64,24,123,120,118,24,24,210,64,29,29,0,24,4,4,4,4,3,4,2,2,2,3,3,1,2024-01-05 04:10:00,0
5187,5187,5187,5187,2021,24,226,24,145,2021,81,24,126,122,118,24,24,226,81,28,28,0,24,4,4,4,4,4,8,2,2,2,4,4,0,2024-01-05 04:12:00,0
5137,5136,5136,5136,2004,24,216,24,143,2004,73,24,120,118,117,24,24,216,73,27,27,0,24,4,4,4,4,3,2,2,2,2,2,2,1,2024-01-05 04:14:00,0
5175,5176,5176,5176,2028,24,205,24,148,2028,57,24,124,120,119,24,24,205,57,31,31,0,24,7,7,7,7,7,2,2,2,2,4,4,0,2024-01-05 04:16:00,0
5205,5205,5205,5205,2034,22,217,22,146,2034,71,22,122,120,118,22,22,217,71,28,28,0,22,4,4,4,4,4,4,2,2,2,2,2,0,2024-01-05 04:18:00,0
5203,5203,5203,5203,2039,24,203,24,145,2039,58,24,125,121,119,24,24,203,58,27,27,0,24,3,3,3,3,3,4,2,2,2,4,4,0,2024-01-05 04:20:00,0
5160,5160,5160,5160,2015,24,206,24,149,2015,57,24,127,121,118,24,24,206,57,32,32,0,24,8,8,8,8,8,6,2,2,2,6,6,0,2024-01-05 04:22:00,0
5183,5183,5183,5183,2030,24,200,24,144,2030,56,24,123,121,119,24,24,200,56,27,27,0,24,3,3,3,3,3,4,2,2,2,2,2,0,2024-01-05 04:24:00,0
5185,5203,5184,5184,2023,24,218,24,145,2023,73,24,122,120,119,24,24,218,73,28,28,0,24,4,4,4,4,3,2,2,2,2,2,2,1,2024-01-05 04:26:00,0
5168,5169,5169,5169,2019,24,210,24,144,2019,66,24,123,120,117,24,24,210,66,28,28,0,24,4,4,4,4,4,6,2,2,2,3,3,0,2024-01-05 04:28:00,0
5206,5206,5206,5206,2033,24,223,24,149,2033,74,24,123,120,119,24,24,223,74,31,31,0,24,7,7,7,7,6,2,2,2,2,3,3,1,2024-01-05 04:30:00,0
5199,5198,5198,5198,2031,24,216,24,146,2031,70,24,121,119,119,24,24,216,70,28,28,0,24,4,4,4,4,4,0,2,2,2,2,2,0,2024-01-05 04:32:00,0
5171,5171,5171,5171,2018,24,214,24,144,2018,70,24,124,120,118,24,24,214,70,28,28,0,24,4,4,4,4,4,4,2,2,2,4,4,0,2024-01-05 04:34:00,0
5137,5138,5138,5138,2005,24,212,24,143,2005,69,24,122,118,117,24,24,212,69,27,27,0,24,3,3,3,3,3,2,2,2,2,4,4,0,2024-01-05 04:36:00,0
5207,5207,5207,5207,2029,24,227,24,150,2029,77,24,129,122,118,24,24,227,77,32,32,0,24,8,8,8,8,8,8,2,2,2,7,7,0,2024-01-05 04:38:00,0
5186,5186,5186,5186,2024,24,213,24,144,2024,69,24,124,120,118,24,24,213,69,27,27,0,24,3,3,3,3,3,4,2,2,2,4,4,0,2024-01-05 04:40:00,0
5152,5152,5152,5152,2016,30,202,25,145,2017,57,25,122,119,118,25,24,202,57,28,28,0,24,4,4,4,4,3,2,2,2,2,3,3,1,2024-01-05 04:42:00,2
5187,5188,5187,5187,2031,22,209,22,148,2031,61,22,123,120,118,22,22,209,61,31,31,0,22,7,7,7,7,7,4,2,2,2,3,3,0,2024-01-05 04:44:00,0
5195,5195,5195,5195,2036,24,212,24,146,2036,66,24,122,119,118,24,24,212,66,28,28,0,24,4,4,4,4,3,2,2,2,2,3,3,1,2024-01-05 04:46:00,0
5181,5181,5181,5181,2023,24,218,24,145,2023,73,24,122,120,119,24,24,218,73,28,28,0,24,4,4,4,4,4,2,2,2,2,2,2,0,2024-01-05 04:48:00,0
5207,5226,5207,5207,2029,24,278,24,146,2029,132,24,127,123,118,24,24,278,81,29,29,0,24,5,5,4,4,4,10,2,2,2,4,4,0,2024-01-05 04:50:00,52
5517,5517,5517,5517,2027,64,253,64,187,2027,66,64,179,177,175,64,64,253,66,31,31,0,64,7,7,7,7,7,4,2,2,2,2,2,0,2024-01-05 04:52:00,0
5635,5635,5635,5635,2028,84,292,84,208,2028,84,84,190,186,183,84,84,292,84,28,28,0,84,4,4,4,4,4,6,2,2,2,4,4,0,2024-01-05 04:54:00,0
5678,5699,5678,5678,2026,103,301,103,222,2026,79,103,190,189,184,103,103,301,79,28,28,0,103,4,4,4,4,3,10,2,2,2,1,1,1,2024-01-05 04:56:00,0
5645,5644,5644,5644,2025,83,298,83,224,2025,74,83,189,184,182,83,83,298,74,31,31,0,83,7,7,7,7,7,4,2,2,2,5,5,0,2024-01-05 04:58:00,0
5595,5596,5596,5596,2007,96,275,96,201,2007,74,96,196,192,191,96,96,275,74,27,27,0,96,3,3,3,3,3,2,2,2,2,4,4,0,2024-01-05 05:00:00,0
5636,5635,5635,5635,2019,98,373,98,203,2019,170,98,193,188,184,98,98,373,170,28,28,0,98,4,4,4,4,3,8,2,2,2,5,5,1,2024-01-05 05:02:00,0
5683,5683,5683,5683,2030,86,283,86,216,2030,67,86,204,199,196,86,86,283,67,28,28,0,86,4,4,4,4,4,6,2,2,2,5,5,0,2024-01-05 05:04:00,0
5649,5650,5650,5650,2022,94,293,94,223,2022,70,94,193,187,186,94,94,293,70,31,31,0,94,7,7,7,7,7,2,2,2,2,6,6,0,2024-01-05 05:06:00,0
5677,5675,5675,5675,2034,100,271,100,213,2034,58,100,196,191,190,100,100,271,58,28,28,0,100,4,4,4,4,4,2,2,2,2,5,5,0,2024-01-05 05:08:00,0
5671,5673,5673,5673,2029,96,281,96,211,2029,70,96,202,199,197,96,96,281,70,28,28,0,96,4,4,4,4,4,4,2,2,2,3,3,0,2024-01-05 05:10:00,0
5700,5698,5698,5698,2027,104,291,104,214,2027,77,104,201,193,191,104,104,291,77,28,28,0,104,4,4,4,4,3,4,2,2,2,8,8,1,2024-01-05 05:12:00,0
5669,5671,5671,5671,2033,93,289,93,219,2033,70,93,199,192,191,93,93,289,70,31,31,0,93,7,7,7,7,7,2,2,2,2,7,7,0,2024-01-05 05:14:00,0
5674,5674,5674,5674,2038,88,284,88,221,2038,63,88,189,184,183,88,88,284,63,27,27,0,88,3,3,3,3,3,2,2,2,2,5,5,0,2024-01-05 05:16:00,0
5667,5666,5666,5666,2033,93,284,93,216,2033,68,93,190,188,187,93,93,284,68,28,28,0,93,4,4,4,4,3,2,2,2,2,2,2,1,2024-01-05 05:18:00,0
5610,5629,5610,5610,2021,92,266,92,212,2021,54,92,179,175,174,92,92,266,54,32,32,0,92,8,8,8,8,8,2,2,2,2,4,4,0,2024-01-05 05:20:00,0
5607,5606,5606,5606,2003,101,272,101,215,2003,57,101,191,190,189,101,101,272,57,27,27,0,101,3,3,3,3,3,2,2,2,2,1,1,0,2024-01-05 05:22:00,0
5652,5653,5653,5653,2033,87,273,87,211,2033,62,87,199,195,191,87,87,273,62,28,28,0,87,4,4,4,4,4,8,2,2,2,4,4,0,2024-01-05 05:24:00,0
5634,5635,5635,5635,2022,95,269,95,221,2022,48,95,193,190,190,95,95,269,48,28,28,0,95,4,4,4,4,4,0,2,2,2,3,3,0,2024-01-05 05:26:00,0
5659,5659,5659,5659,2037,97,298,97,232,2037,66,97,186,182,182,97,97,298,66,31,31,0,97,7,7,7,7,6,0,2,2,2,4,4,1,2024-01-05 05:28:00,0
5655,5693,5654,5654,2023,92,272,92,215,2023,57,92,206,202,202,92,92,272,57,28,28,0,92,4,4,4,4,4,0,2,2,2,4,4,0,2024-01-05 05:30:00,0
5699,5700,5700,5700,2044,101,286,101,206,2044,80,101,200,197,193,101,101,286,80,28,28,0,101,4,4,4,4,3,8,2,2,2,3,3,1,2024-01-05 05:32:00,0
5649,5649,5649,5649,2025,93,282,93,216,2025,66,93,182,179,178,93,93,282,66,27,27,0,93,3,3,3,3,3,2,2,2,2,3,3,0,2024-01-05 05:34:00,0
5623,5622,5622,5622,2020,81,278,81,221,2020,57,81,187,183,181,81,81,278,57,32,32,0,81,8,8,8,8,8,4,2,2,2,4,4,0,2024-01-05 05:36:00,0
5667,5666,5666,5666,2034,94,281,94,225,2034,56,94,196,193,189,94,94,281,56,27,27,0,94,3,3,3,3,3,8,2,2,2,3,3,0,2024-01-05 05:38:00,0
5644,5646,5646,5646,2018,100,281,100,201,2018,80,100,184,183,183,100,100,281,80,28,28,0,100,4,4,4,4,4,0,2,2,2,1,1,0,2024-01-05 05:40:00,0
5610,5610,5610,5610,2004,97,292,97,218,2004,74,97,186,184,183,97,97,292,74,32,32,0,97,7,7,7,7,7,2,2,2,2,2,2,0,2024-01-05 05:42:00,2
5646,5645,5645,5645,2029,83,278,82,212,2029,66,82,190,188,186,82,82,278,66,28,28,0,82,4,4,4,4,3,4,2,2,2,2,2,1,2024-01-05 05:44:00,0
5610,5611,5611,5611,2015,97,265,98,211,2015,54,98,191,190,188,98,98,265,54,28,28,0,98,4,4,4,4,4,4,2,2,2,1,1,0,2024-01-05 05:46:00,0
5634,5634,5634,5634,2016,100,277,100,216,2016,61,100,194,186,186,100,100,277,61,28,28,0,100,4,4,4,4,3,0,2,2,2,8,8,1,2024-01-05 05:48:00,0
5622,5620,5620,5620,2024,87,338,87,214,2024,124,87,184,179,178,87,87,338,73,32,32,0,87,8,8,7,7,7,2,2,2,2,5,5,0,2024-01-05 05:50:00,52
5662,5663,5663,5663,2030,99,287,99,214,2030,73,99,187,185,181,99,99,287,73,28,28,0,99,4,4,4,4,4,8,2,2,2,2,2,0,2024-01-05 05:52:00,0
5639,5640,5640,5640,2037,87,266,87,209,2037,57,87,191,188,186,87,87,266,57,27,27,0,87,3,3,3,3,3,4,2,2,2,3,3,0,2024-01-05 05:54:00,0
5609,5628,5608,5608,2024,87,265,87,212,2024,53,87,192,188,187,87,87,265,53,28,28,0,87,4,4,4,4,4,2,2,2,2,4,4,0,2024-01-05 05:56:00,0
5660,5662,5661,5661,2024,86,275,86,218,2024,57,86,199,192,189,86,86,275,57,31,31,0,86,7,7,7,7,7,6,2,2,2,7,7,0,2024-01-05 05:58:00,0
5643,5643,5643,5643,2027,94,273,94,210,2027,63,94,192,189,185,94,94,273,63,28,28,0,94,4,4,4,4,3,8,2,2,2,3,3,1,2024-01-05 06:00:00,0
5615,5614,5615,5615,1999,100,372,100,216,1999,156,100,191,191,191,100,100,372,156,28,28,0,100,4,4,4,4,4,0,2,2,2,0,0,0,2024-01-05 06:02:00,0
5640,5638,5638,5638,2022,104,385,104,209,2022,176,104,194,190,190,104,104,385,176,31,31,0,104,7,7,7,7,6,0,2,2,2,4,4,1,2024-01-05 06:04:00,0
5644,5646,5646,5646,2029,86,298,86,222,2029,76,86,187,184,184,86,86,298,76,28,28,0,86,4,4,4,4,4,0,2,2,2,3,3,0,2024-01-05 06:06:00,0
5634,5633,5633,5633,2039,91,258,91,203,2039,55,91,185,181,181,91,91,258,55,28,28,0,91,4,4,4,4,4,0,2,2,2,4,4,0,2024-01-05 06:08:00,0
5569,5589,5570,5570,1995,93,261,93,212,1995,49,93,192,190,187,93,93,261,49,27,27,0,93,3,3,3,3,3,6,2,2,2,2,2,0,2024-01-05 06:10:00,0
5652,5651,5651,5651,2016,97,298,97,217,2016,81,97,189,187,187,97,97,298,81,32,32,0,97,8,8,8,8,8,0,2,2,2,2,2,0,2024-01-05 06:12:00,0
5633,5634,5634,5634,2018,92,270,92,214,2018,56,92,201,195,193,92,92,270,56,27,27,0,92,3,3,3,3,3,4,2,2,2,6,6,0,2024-01-05 06:14:00,0
5647,5647,5647,5647,2022,92,282,92,217,2022,65,92,196,193,189,92,92,282,65,28,28,0,92,4,4,4,4,3,8,2,2,2,3,3,1,2024-01-05 06:16:00,0
5662,5662,5662,5662,2040,97,277,97,209,2040,68,97,181,179,179,97,97,277,68,31,31,0,97,7,7,7,7,7,0,2,2,2,2,2,0,2024-01-05 06:18:00,0
5688,5688,5688,5688,2030,95,287,95,217,2030,70,95,200,196,195,95,95,287,70,28,28,0,95,4,4,4,4,3,2,2,2,2,4,4,1,2024-01-05 06:20:00,0
5600,5600,5600,5600,2017,89,254,89,208,2017,46,89,194,190,189,89,89,254,46,28,28,0,89,4,4,4,4,4,2,2,2,2,4,4,0,2024-01-05 06:22:00,0
5612,5611,5611,5611,2025,87,250,87,203,2025,47,87,197,194,192,87,87,250,47,28,28,0,87,4,4,4,4,4,4,2,2,2,3,3,0,2024-01-05 06:24:00,0
5645,5646,5646,5646,2036,85,274,85,223,2036,51,85,188,186,183,85,85,274,51,31,31,0,85,7,7,7,7,7,6,2,2,2,2,2,0,2024-01-05 06:26:00,0
5660,5660,5660,5660,2032,99,265,99,211,2032,54,99,198,196,195,99,99,265,54,28,28,0,99,4,4,4,4,4,2,2,2,2,2,2,0,2024-01-05 06:28:00,0
5681,5681,5681,5681,2038,96,280,96,209,2038,71,96,201,195,190,96,96,280,71,27,27,0,96,3,3,3,3,3,10,2,2,2,6,6,0,2024-01-05 06:30:00,0
5623,5641,5621,5621,2032,88,277,88,216,2032,61,88,188,183,181,88,88,277,61,28,28,0,88,4,4,4,4,3,4,2,2,2,5,5,1,2024-01-05 06:32:00,0
5563,5565,5565,5565,2004,88,259,88,212,2004,47,88,188,184,184,88,88,259,47,30,30,0,88,7,7,7,7,7,0,2,2,2,4,4,0,2024-01-05 06:34:00,0
5659,5679,5659,5659,2025,90,307,90,227,2025,80,90,186,184,182,90,90,307,80,28,28,0,90,4,4,4,4,3,4,2,2,2,2,2,1,2024-01-05 06:36:00,0
5653,5653,5653,5653,2028,89,276,89,212,2028,64,89,187,182,182,89,89,276,64,28,28,0,89,4,4,4,4,4,0,2,2,2,5,5,0,2024-01-05 06:38:00,0
5667,5667,5667,5667,2039,93,286,93,208,2039,78,93,191,188,184,93,93,286,78,28,28,0,93,4,4,4,4,4,8,2,2,2,3,3,0,2024-01-05 06:40:00,0
5638,5638,5638,5638,2019,96,286,96,227,2019,59,96,200,197,194,96,96,286,59,31,31,0,96,7,7,7,7,7,6,2,2,2,3,3,0,2024-01-05 06:42:00,0
5662,5661,5661,5661,2031,93,276,93,210,2031,66,93,194,191,188,93,93,276,66,28,28,0,93,4,4,4,4,4,6,2,2,2,3,3,0,2024-01-05 06:44:00,0
5629,5629,5629,5629,2034,91,275,91,210,2034,65,91,180,179,178,91,91,275,65,29,29,0,91,4,4,4,4,3,2,2,2,2,1,1,1,2024-01-05 06:46:00,0
5658,5660,5659,5659,2022,96,289,96,209,2022,80,96,196,193,190,96,96,289,80,31,31,0,96,7,7,7,7,7,6,2,2,2,3,3,0,2024-01-05 06:48:00,0
5670,5668,5668,5668,2039,96,333,96,217,2039,116,96,197,194,193,96,96,333,65,28,28,0,96,4,4,3,3,3,2,2,2,2,3,3,0,2024-01-05 06:50:00,52
5619,5619,5619,5619,2019,83,276,83,214,2019,62,83,193,191,189,83,83,276,62,28,28,0,83,4,4,4,4,3,4,2,2,2,2,2,1,2024-01-05 06:52:00,0
5644,5645,5645,5645,2027,90,286,90,211,2027,75,90,186,183,182,90,90,286,75,28,28,0,90,4,4,4,4,4,2,2,2,2,3,3,0,2024-01-05 06:54:00,0
5653,5652,5652,5652,2031,93,289,92,217,2031,72,92,187,187,186,92,92,289,72,31,31,0,92,7,7,7,7,7,2,2,2,2,0,0,0,2024-01-05 06:56:00,0
5593,5595,5595,5595,2005,87,276,88,212,2005,64,88,180,178,177,88,88,276,64,27,27,4,88,4,4,4,4,4,2,2,2,2,2,2,0,2024-01-05 06:58:00,0
5635,5635,5635,5635,2027,98,272,98,214,2027,58,98,182,180,176,98,98,272,58,28,28,0,98,4,4,4,4,4,8,2,2,2,2,2,0,2024-01-05 07:00:00,0
5655,5655,5655,5655,2020,88,487,88,222,2020,265,88,186,183,181,88,88,487,265,31,31,0,88,7,7,7,7,6,4,2,2,2,3,3,1,2024-01-05 07:02:00,0
5626,5625,5625,5625,2025,94,269,94,204,2025,65,94,191,191,191,94,94,269,65,28,28,0,94,4,4,4,4,4,0,2,2,2,0,0,0,2024-01-05 07:04:00,0
5624,5625,5625,5625,2029,103,271,103,216,2029,55,103,188,182,179,103,103,271,55,27,27,0,103,3,3,3,3,3,6,2,2,2,6,6,0,2024-01-05 07:06:00,0
5696,5696,5696,5696,2037,105,300,105,217,2037,83,105,194,191,190,105,105,300,83,28,28,0,105,4,4,4,4,3,2,2,2,2,3,3,1,2024-01-05 07:08:00,0
5652,5651,5651,5651,2036,92,284,92,229,2036,55,92,182,180,178,92,92,284,55,32,32,0,92,8,8,8,8,8,4,2,2,2,2,2,0,2024-01-05 07:10:00,0
5612,5612,5612,5612,2015,93,272,93,211,2015,61,93,196,194,192,93,93,272,61,27,27,0,93,3,3,3,3,3,4,2,2,2,2,2,0,2024-01-05 07:12:00,0
5646,5646,5646,5646,2021,99,285,99,216,2021,69,99,196,191,188,99,99,285,69,28,28,0,99,4,4,4,4,4,6,2,2,2,5,5,0,2024-01-05 07:14:00,0
5647,5648,5648,5648,2025,90,277,90,215,2025,62,90,194,190,189,90,90,277,62,31,31,0,90,7,7,7,7,7,2,2,2,2,4,4,0,2024-01-05 07:16:00,0
5672,5672,5672,5672,2032,92,295,92,220,2032,75,92,189,187,183,92,92,295,75,28,28,0,92,4,4,4,4,3,8,2,2,2,2,2,1,2024-01-05 07:18:00,0
5606,5605,5605,5605,2016,95,270,95,206,2016,64,95,191,185,183,95,95,270,64,28,28,0,95,4,4,4,4,4,4,2,2,2,6,6,0,2024-01-05 07:20:00,0
5606,5607,5607,5607,2012,96,277,96,229,2012,48,96,194,191,190,96,96,277,48,28,28,0,96,4,4,4,4,3,2,2,2,2,3,3,1,2024-01-05 07:22:00,0
5638,5638,5638,5638,2034,82,261,82,208,2034,53,82,193,191,189,82,82,261,53,31,31,0,82,7,7,7,7,7,4,2,2,2,2,2,0,2024-01-05 07:24:00,0
5630,5648,5628,5628,2026,96,266,96,220,2026,46,96,189,185,184,96,96,266,46,28,28,0,96,4,4,4,4,4,2,2,2,2,4,4,0,2024-01-05 07:26:00,0
5657,5656,5656,5656,2032,95,286,95,220,2032,66,95,184,183,182,95,95,286,66,27,27,0,95,3,3,3,3,3,2,2,2,2,1,1,0,2024-01-05 07:28:00,0
5667,5668,5668,5668,2044,96,271,96,206,2044,65,96,194,192,191,96,96,271,65,28,28,0,96,4,4,4,4,4,2,2,2,2,2,2,0,2024-01-05 07:30:00,0
6940,6943,6943,6943,2487,98,381,98,280,2487,101,98,232,230,225,98,98,381,101,36,36,0,98,7,7,7,7,7,10,3,3,3,2,2,0,2024-01-05 07:32:00,0
5650,5649,5649,5649,2024,105,264,105,214,2024,50,105,192,191,190,105,105,264,50,28,28,0,105,4,4,4,4,3,2,2,2,2,1,1,1,2024-01-05 07:34:00,0
5619,5618,5618,5618,2023,92,276,92,210,2023,66,92,185,185,184,92,92,276,66,28,28,0,92,4,4,4,4,4,2,2,2,2,0,0,0,2024-01-05 07:36:00,0
5556,5556,5556,5556,1996,83,275,82,208,1996,67,82,189,186,180,82,82,275,67,31,31,0,82,7,7,7,7,6,12,2,2,2,3,3,1,2024-01-05 07:38:00,0
5661,5662,5662,5662,2029,103,281,104,211,2029,70,104,207,205,203,104,104,281,70,28,28,0,104,4,4,4,4,4,4,2,2,2,2,2,0,2024-01-05 07:40:00,0
5618,5619,5619,5619,2008,92,296,92,216,2008,80,92,193,189,185,92,92,296,80,28,28,0,92,4,4,4,4,4,8,2,2,2,4,4,0,2024-01-05 07:42:00,0
5658,5657,5657,5657,2024,92,283,92,219,2024,64,92,187,185,183,92,92,283,64,27,27,0,92,3,3,3,3,3,4,2,2,2,2,2,0,2024-01-05 07:44:00,0
5629,5630,5630,5630,2026,85,289,85,211,2026,78,85,197,190,188,85,85,289,78,32,32,0,85,8,8,8,8,8,4,2,2,2,7,7,0,2024-01-05 07:46:00,0
5660,5660,5660,5660,2032,95,268,95,210,2032,58,95,187,184,184,95,95,268,58,27,27,0,95,3,3,3,3,3,0,2,2,2,3,3,0,2024-01-05 07:48:00,0
5679,5676,5677,5677,2035,85,343,85,211,2035,132,85,193,190,188,85,85,343,81,29,29,0,85,5,5,4,4,3,4,2,2,2,3,3,1,2024-01-05 07:50:00,52
5619,5622,5621,5621,2021,90,269,90,211,2021,58,90,200,194,193,90,90,269,58,28,28,0,90,4,4,4,4,4,2,2,2,2,6,6,0,2024-01-05 07:52:00,0
5625,5625,5625,5625,2028,97,275,97,219,2028,56,97,194,192,191,97,97,275,56,31,31,0,97,7,7,7,7,6,2,2,2,2,2,2,1,2024-01-05 07:54:00,0
5677,5677,5677,5677,2031,95,286,95,213,2031,73,95,207,203,201,95,95,286,73,28,28,0,95,4,4,4,4,4,4,2,2,2,4,4,0,2024-01-05 07:56:00,0
5667,5667,5667,5667,2023,101,271,101,208,2023,63,101,196,193,191,101,101,271,63,28,28,0,101,4,4,4,4,4,4,2,2,2,3,3,0,2024-01-05 07:58:00,0
5645,5645,5645,5645,2025,96,271,91,218,2026,53,91,203,200,197,91,90,271,53,31,31,0,90,7,7,7,7,7,6,2,2,2,3,3,0,2024-01-05 08:00:00,2
5634,5632,5632,5632,1990,106,294,106,212,1990,82,106,195,190,188,106,106,294,82,28,28,0,106,4,4,4,4,4,4,2,2,2,5,5,0,2024-01-05 08:02:00,0
5654,5654,5654,5654,2021,98,302,98,223,2021,79,98,197,194,193,98,98,302,79,27,27,0,98,3,3,3,3,3,2,2,2,2,3,3,0,2024-01-05 08:04:00,0
5635,5637,5637,5637,2022,84,274,84,213,2022,61,84,192,184,181,84,84,274,61,28,28,0,84,4,4,4,4,3,6,2,2,2,8,8,1,2024-01-05 08:06:00,0
5624,5623,5623,5623,2026,94,284,94,216,2026,68,94,185,183,183,94,94,284,68,31,31,0,94,7,7,7,7,7,0,2,2,2,2,2,0,2024-01-05 08:08:00,0
5658,5660,5659,5659,2027,92,294,92,214,2027,80,92,195,190,186,92,92,294,80,28,28,0,92,4,4,4,4,3,8,2,2,2,5,5,1,2024-01-05 08:10:00,0
5636,5636,5636,5636,2018,97,284,97,216,2018,68,97,193,191,191,97,97,284,68,28,28,0,97,4,4,4,4,4,0,2,2,2,2,2,0,2024-01-05 08:12:00,0
5646,5645,5645,5645,2025,87,277,87,215,2025,62,87,193,188,187,87,87,277,62,31,31,0,87,7,7,7,7,7,2,2,2,2,5,5,0,2024-01-05 08:14:00,0
5653,5674,5654,5654,2027,88,291,88,213,2027,78,88,197,194,191,88,88,291,78,28,28,0,88,4,4,4,4,4,6,2,2,2,3,3,0,2024-01-05 08:16:00,0
5673,5672,5672,5672,2036,99,282,99,217,2036,65,99,191,186,184,99,99,282,65,28,28,0,99,4,4,4,4,4,4,2,2,2,5,5,0,2024-01-05 08:18:00,0
5672,5673,5673,5673,2031,95,299,95,223,2031,76,95,188,186,186,95,95,299,76,28,28,0,95,4,4,4,4,3,0,2,2,2,2,2,1,2024-01-05 08:20:00,0
5638,5638,5638,5638,2021,84,296,84,225,2021,71,84,193,188,186,84,84,296,71,31,31,0,84,7,7,7,7,7,4,2,2,2,5,5,0,2024-01-05 08:22:00,0
5652,5652,5652,5652,2032,93,271,93,213,2032,58,93,183,179,178,93,93,271,58,28,28,0,93,3,3,3,3,3,2,2,2,2,4,4,0,2024-01-05 08:24:00,2
5595,5614,5594,5594,2017,96,264,96,212,2017,52,96,186,185,184,96,96,264,52,28,28,0,96,4,4,4,4,3,2,2,2,2,1,1,1,2024-01-05 08:26:00,0
5702,5702,5702,5702,2042,102,292,102,219,2042,73,102,182,179,179,102,102,292,73,28,28,0,102,4,4,4,4,4,0,2,2,2,3,3,0,2024-01-05 08:28:00,0
5638,5638,5638,5638,2034,81,281,81,219,2034,62,81,199,194,194,81,81,281,62,31,31,0,81,7,7,7,7,7,0,2,2,2,5,5,0,2024-01-05 08:30:00,0
5655,5655,5655,5655,2024,91,272,91,212,2024,60,91,198,195,193,91,91,272,60,28,28,0,91,4,4,4,4,4,4,2,2,2,3,3,0,2024-01-05 08:32:00,0
5629,5629,5629,5629,2014,84,287,84,213,2014,74,84,184,183,181,84,84,287,74,29,29,0,84,4,4,4,4,4,4,2,2,2,1,1,0,2024-01-05 08:34:00,2
5582,5583,5583,5583,2002,92,270,92,211,2002,59,92,184,184,183,92,92,270,59,28,28,0,92,4,4,4,4,3,2,2,2,2,0,0,1,2024-01-05 08:36:00,0
5643,5641,5641,5641,2006,101,296,101,219,2006,77,101,188,187,186,101,101,296,77,31,31,0,101,7,7,7,7,7,2,2,2,2,1,1,0,2024-01-05 08:38:00,0
5645,5647,5647,5647,2016,91,279,91,218,2016,61,91,194,190,190,91,91,279,61,27,27,0,91,3,3,3,3,3,0,2,2,2,4,4,0,2024-01-05 08:40:00,0
5624,5624,5623,5623,2007,98,269,98,205,2007,64,98,199,198,193,98,98,269,64,28,28,0,98,4,4,4,4,3,10,2,2,2,1,1,1,2024-01-05 08:42:00,0
5615,5635,5616,5616,2018,87,272,87,215,2018,57,87,193,191,190,87,87,272,57,32,32,0,87,8,8,8,8,8,2,2,2,2,2,2,0,2024-01-05 08:44:00,0
5647,5646,5646,5646,2032,89,274,89,211,2032,63,89,186,186,186,89,89,274,63,27,27,0,89,3,3,3,3,3,0,2,2,2,0,0,0,2024-01-05 08:46:00,0
5679,5680,5680,5680,2033,87,277,87,218,2033,59,87,198,192,190,87,87,277,59,28,28,0,87,4,4,4,4,4,4,2,2,2,6,6,0,2024-01-05 08:48:00,0
5622,5621,5621,5621,2006,97,344,97,215,2006,129,97,194,188,186,97,97,344,78,29,29,0,97,5,5,4,4,4,4,2,2,2,6,6,0,2024-01-05 08:50:00,52
5621,5622,5622,5622,2025,93,267,93,210,2025,57,93,190,185,183,93,93,267,57,31,31,0,93,7,7,7,7,6,4,2,2,2,5,5,1,2024-01-05 08:52:00,0
5654,5654,5654,5654,2026,87,290,87,212,2026,78,87,195,191,190,87,87,290,78,28,28,0,87,4,4,4,4,4,2,2,2,2,4,4,0,2024-01-05 08:54:00,0
5643,5643,5643,5643,2026,89,275,89,206,2026,69,89,191,191,188,89,89,275,69,28,28,0,89,4,4,4,4,3,6,2,2,2,0,0,1,2024-01-05 08:56:00,0
5640,5640,5640,5640,2019,101,279,101,214,2019,65,101,186,185,183,101,101,279,65,27,27,0,101,3,3,3,3,3,4,2,2,2,1,1,0,2024-01-05 08:58:00,0
5644,5643,5643,5643,2031,90,272,90,217,2031,55,90,187,183,181,90,90,272,55,32,32,0,90,8,8,8,8,8,4,2,2,2,4,4,0,2024-01-05 09:00:00,0
5603,5622,5603,5603,2008,94,366,94,211,2008,155,94,199,190,187,94,94,366,155,27,27,0,94,3,3,3,3,3,6,2,2,2,9,9,0,2024-01-05 09:02:00,0
5637,5638,5638,5638,2039,85,265,85,216,2039,49,85,189,185,184,85,85,265,49,28,28,0,85,4,4,4,4,4,2,2,2,2,4,4,0,2024-01-05 09:04:00,0
5687,5685,5685,5685,2028,93,297,93,219,2028,78,93,193,189,189,93,93,297,78,31,31,0,93,7,7,7,7,7,0,2,2,2,4,4,0,2024-01-05 09:06:00,0
5626,5628,5628,5628,2029,92,286,92,220,2029,66,92,185,182,178,92,92,286,66,28,28,0,92,4,4,4,4,3,8,2,2,2,3,3,1,2024-01-05 09:08:00,0
5644,5643,5643,5643,2026,94,286,94,216,2026,70,94,188,184,183,94,94,286,70,28,28,0,94,4,4,4,4,4,2,2,2,2,4,4,0,2024-01-05 09:10:00,0
5658,5659,5659,5659,2036,86,277,86,215,2036,62,86,191,190,188,86,86,277,62,28,28,0,86,4,4,4,4,3,4,2,2,2,1,1,1,2024-01-05 09:12:00,0
5606,5606,5606,5606,2009,91,296,91,217,2009,79,91,196,191,191,91,91,296,79,31,31,0,91,7,7,7,7,7,0,2,2,2,5,5,0,2024-01-05 09:14:00,0
5659,5657,5657,5657,2033,100,249,100,192,2033,57,100,191,188,188,100,100,249,57,28,28,0,100,4,4,4,4,4,0,2,2,2,3,3,0,2024-01-05 09:16:00,0
5659,5660,5660,5660,2023,105,273,105,213,2023,60,105,191,183,182,105,105,273,60,27,27,0,105,3,3,3,3,3,2,2,2,2,8,8,0,2024-01-05 09:18:00,0
5639,5640,5640,5640,2022,87,262,87,210,2022,52,87,199,194,192,87,87,262,52,32,32,0,87,8,8,8,8,8,4,2,2,2,5,5,0,2024-01-05 09:20:00,0
5627,5627,5627,5627,2017,94,263,94,207,2017,56,94,186,184,182,94,94,263,56,27,27,0,94,3,3,3,3,3,4,2,2,2,2,2,0,2024-01-05 09:22:00,0
5632,5631,5631,5631,2028,95,276,95,217,2028,59,95,180,174,174,95,95,276,59,28,28,0,95,4,4,4,4,3,0,2,2,2,6,6,1,2024-01-05 09:24:00,0
5630,5631,5631,5631,2035,95,255,95,205,2035,50,95,188,186,185,95,95,255,50,28,28,0,95,4,4,4,4,4,2,2,2,2,2,2,0,2024-01-05 09:26:00,0
5620,5620,5620,5620,2027,89,262,89,201,2027,61,89,201,196,194,89,89,262,61,31,31,0,89,7,7,7,7,6,4,2,2,2,5,5,1,2024-01-05 09:28:00,0
5591,5591,5591,5591,2018,91,256,91,204,2018,52,91,189,188,187,91,91,256,52,28,28,0,91,4,4,4,4,4,2,2,2,2,1,1,0,2024-01-05 09:30:00,0
5643,5640,5640,5640,2026,91,280,91,217,2026,63,91,190,184,183,91,91,280,63,28,28,0,91,4,4,4,4,4,2,2,2,2,6,6,0,2024-01-05 09:32:00,0
5635,5638,5638,5638,2020,106,275,106,205,2020,70,106,190,186,186,106,106,275,70,27,27,0,106,3,3,3,3,3,0,2,2,2,4,4,0,2024-01-05 09:34:00,0
5657,5657,5657,5657,2029,102,279,102,220,2029,59,102,186,185,184,102,102,279,59,32,32,0,102,8,8,8,8,8,2,2,2,2,1,1,0,2024-01-05 09:36:00,0
5601,5602,5601,5601,2005,91,267,91,204,2005,63,91,177,176,175,91,91,267,63,26,26,0,91,3,3,3,3,3,2,2,2,2,1,1,0,2024-01-05 09:38:00,0
5660,5659,5659,5659,2036,93,274,93,214,2036,60,93,182,179,178,93,93,274,60,28,28,0,93,4,4,4,4,3,2,2,2,2,3,3,1,2024-01-05 09:40:00,0
5590,5591,5591,5591,2012,90,276,90,212,2012,64,90,186,184,181,90,90,276,64,31,31,0,90,7,7,7,7,7,6,2,2,2,2,2,0,2024-01-05 09:42:00,0
5654,5653,5653,5653,2033,101,286,101,214,2033,72,101,186,186,185,101,101,286,72,28,28,0,101,4,4,4,4,3,2,2,2,2,0,0,1,2024-01-05 09:44:00,0
5639,5638,5638,5638,2023,91,286,91,213,2023,73,91,187,184,181,91,91,286,73,28,28,0,91,4,4,4,4,4,6,2,2,2,3,3,0,2024-01-05 09:46:00,0
5640,5640,5640,5640,2030,93,274,93,217,2030,57,93,195,191,190,93,93,274,57,28,28,0,93,4,4,4,4,4,2,2,2,2,4,4,0,2024-01-05 09:48:00,0
5611,5613,5613,5613,2020,78,337,78,217,2020,120,78,173,170,169,78,78,337,69,32,32,0,78,8,8,7,7,7,2,2,2,2,3,3,0,2024-01-05 09:50:00,52
5680,5678,5678,5678,2031,99,284,99,226,2031,58,99,189,185,182,99,99,284,58,28,28,0,99,4,4,4,4,4,6,2,2,2,4,4,0,2024-01-05 09:52:00,0
5648,5649,5649,5649,2035,86,271,86,211,2035,60,86,197,194,191,86,86,271,60,28,28,0,86,4,4,4,4,3,6,2,2,2,3,3,1,2024-01-05 09:54:00,0
5685,5686,5686,5686,2027,80,318,80,235,2027,83,80,206,204,200,80,80,318,83,31,31,0,80,7,7,7,7,7,8,2,2,2,2,2,0,2024-01-05 09:56:00,0
5657,5657,5657,5657,2034,91,282,91,209,2034,73,91,197,194,193,91,91,282,73,27,27,3,91,3,3,3,3,3,2,2,2,2,3,3,0,2024-01-05 09:58:00,0
5626,5626,5626,5626,2024,91,264,91,206,2024,58,91,189,185,181,91,91,264,58,28,28,0,91,4,4,4,4,3,8,2,2,2,4,4,1,2024-01-05 10:00:00,0
5581,5581,5581,5581,2001,84,481,84,212,2001,269,84,199,195,191,84,84,481,269,28,28,0,84,4,4,4,4,4,8,2,2,2,4,4,0,2024-01-05 10:02:00,0
5659,5659,5659,5659,2024,105,270,105,208,2024,62,105,182,180,177,105,105,270,62,31,31,0,105,7,7,7,7,7,6,2,2,2,2,2,0,2024-01-05 10:04:00,0
5641,5640,5640,5640,2024,94,278,94,220,2024,58,94,185,184,183,94,94,278,58,28,28,0,94,4,4,4,4,4,2,2,2,2,1,1,0,2024-01-05 10:06:00,0
5682,5681,5681,5681,2024,95,293,95,217,2024,76,95,192,191,188,95,95,293,76,28,28,0,95,4,4,4,4,4,6,2,2,2,1,1,0,2024-01-05 10:08:00,0
5658,5659,5659,5659,2028,89,275,89,206,2028,69,89,196,191,189,89,89,275,69,28,28,0,89,4,4,4,4,3,4,2,2,2,5,5,1,2024-01-05 10:10:00,0
5635,5636,5636,5636,2018,87,277,87,227,2018,50,87,190,189,186,87,87,277,50,31,31,0,87,7,7,7,7,7,6,2,2,2,1,1,0,2024-01-05 10:12:00,0
5652,5652,5652,5652,2033,93,411,93,360,2033,51,93,192,185,185,93,93,411,51,161,161,0,93,70,3,3,3,3,0,2,2,2,7,7,0,2024-01-05 10:14:00,201
5581,5580,5580,5580,2018,94,251,94,199,2018,52,94,181,179,179,94,94,251,52,28,28,0,94,4,4,4,4,3,0,2,2,2,2,2,1,2024-01-05 10:16:00,0
5662,5662,5662,5662,2022,98,282,93,218,2023,64,93,193,188,185,93,92,282,64,32,32,0,92,8,8,8,8,8,6,2,2,2,5,5,0,2024-01-05 10:18:00,2
5682,5683,5683,5683,2032,87,301,87,223,2032,78,87,198,197,195,87,87,301,78,27,27,0,87,3,3,3,3,3,4,2,2,2,1,1,0,2024-01-05 10:20:00,0
5660,5681,5659,5659,2009,97,296,97,214,2009,82,97,203,197,193,97,97,296,82,28,28,0,97,4,4,4,4,4,8,2,2,2,6,6,0,2024-01-05 10:22:00,0
5647,5648,5648,5648,2022,92,286,92,217,2022,69,92,195,194,192,92,92,286,69,28,28,7,92,4,4,4,4,4,4,2,2,2,1,1,0,2024-01-05 10:24:00,0
5571,5571,5571,5571,2003,95,265,95,211,2003,54,95,188,185,184,95,95,265,54,31,31,3,95,7,7,7,7,6,2,2,2,2,3,3,1,2024-01-05 10:26:00,0
5643,5643,5643,5643,2031,90,273,90,205,2031,68,90,202,196,193,90,90,273,68,28,28,3,90,4,4,4,4,4,6,2,2,2,6,6,0,2024-01-05 10:28:00,0
5621,5619,5619,5619,2014,83,285,83,220,2014,65,83,190,188,187,83,83,285,65,28,28,1,83,4,4,4,4,3,2,2,2,2,2,2,1,2024-01-05 10:30:00,0
5644,5645,5645,5645,2028,97,287,97,215,2028,72,97,191,190,188,97,97,287,72,31,31,0,97,7,7,7,7,7,4,2,2,2,1,1,0,2024-01-05 10:32:00,0
5644,5645,5645,5645,2032,85,283,85,219,2032,64,85,192,187,184,85,85,283,64,28,28,0,85,4,4,4,4,4,6,2,2,2,5,5,0,2024-01-05 10:34:00,0
5639,5638,5638,5638,2016,91,289,91,221,2016,68,91,181,179,179,91,91,289,68,27,27,3,91,3,3,3,3,3,0,2,2,2,2,2,0,2024-01-05 10:36:00,0
5685,5686,5686,5686,2035,89,278,89,210,2035,68,89,193,190,187,89,89,278,68,28,28,6,89,4,4,4,4,4,6,2,2,2,3,3,0,2024-01-05 10:38:00,0
5640,5639,5639,5639,2025,89,280,89,216,2025,64,89,202,198,197,89,89,280,64,31,31,4,89,7,7,7,7,7,2,2,2,2,4,4,0,2024-01-05 10:40:00,0
5624,5625,5625,5625,2018,96,283,96,211,2018,72,96,202,198,194,96,96,283,72,28,28,0,96,4,4,4,4,3,8,2,2,2,4,4,1,2024-01-05 10:42:00,0
5641,5638,5638,5638,2021,91,270,91,212,2021,58,91,189,185,183,91,91,270,58,28,28,0,91,4,4,4,4,4,4,2,2,2,4,4,0,2024-01-05 10:44:00,0
5642,5645,5645,5645,2025,90,299,90,217,2025,82,90,198,195,195,90,90,299,82,28,28,4,90,4,4,4,4,3,0,2,2,2,3,3,1,2024-01-05 10:46:00,0
5632,5632,5632,5632,2022,97,277,97,209,2022,68,97,187,182,180,97,97,277,68,31,31,2,97,7,7,7,7,7,4,2,2,2,5,5,0,2024-01-05 10:48:00,0
5621,5644,5621,5621,2013,92,342,92,215,2013,127,92,190,186,185,92,92,342,76,29,29,2,92,5,5,4,4,4,2,2,2,2,4,4,0,2024-01-05 10:50:00,52
5636,5637,5635,5635,2025,104,265,104,200,2025,65,104,199,197,194,104,104,265,65,27,27,0,104,3,3,3,3,3,6,2,2,2,2,2,0,2024-01-05 10:52:00,0
5702,5702,5702,5702,2039,100,307,100,219,2039,88,100,197,193,191,100,100,307,88,32,32,2,100,8,8,8,8,8,4,2,2,2,4,4,0,2024-01-05 10:54:00,0
5648,5672,5648,5648,2028,87,283,87,218,2028,65,87,195,192,191,87,87,283,65,27,27,5,87,3,3,3,3,3,2,2,2,2,3,3,0,2024-01-05 10:56:00,0
5668,5669,5669,5669,2035,88,284,88,220,2035,64,88,202,199,199,88,88,284,64,28,28,7,88,4,4,4,4,3,0,2,2,2,3,3,1,2024-01-05 10:58:00,0
5651,5651,5651,5651,2035,89,279,89,205,2035,74,89,189,186,184,89,89,279,74,28,28,3,89,4,4,4,4,4,4,2,2,2,3,3,0,2024-01-05 11:00:00,0
5617,5616,5616,5616,2007,99,281,99,218,2007,63,99,198,194,194,99,99,281,63,31,31,1,99,7,7,7,7,6,0,2,2,2,4,4,1,2024-01-05 11:02:00,0
5637,5638,5638,5638,2016,84,286,84,222,2016,64,84,186,184,180,84,84,286,64,28,28,4,84,4,4,4,4,4,8,2,2,2,2,2,0,2024-01-05 11:04:00,0
5619,5617,5617,5617,2021,86,272,86,218,2021,54,86,187,185,185,86,86,272,54,28,28,3,86,4,4,4,4,4,0,2,2,2,2,2,0,2024-01-05 11:06:00,0
5623,5629,5625,5625,2027,85,289,85,208,2027,81,85,184,183,183,85,85,289,81,27,27,1,85,3,3,3,3,3,0,2,2,2,1,1,0,2024-01-05 11:08:00,0
5680,5679,5679,5679,2037,96,283,96,218,2037,65,96,201,199,197,96,96,283,65,32,32,0,96,8,8,8,8,8,4,2,2,2,2,2,0,2024-01-05 11:10:00,0
5637,5637,5637,5637,2032,95,258,95,204,2032,54,95,188,186,183,95,95,258,54,27,27,4,95,3,3,3,3,3,6,2,2,2,2,2,0,2024-01-05 11:12:00,0
5635,5636,5636,5636,2021,92,275,92,212,2021,63,92,188,184,182,92,92,275,63,28,28,0,92,4,4,4,4,3,4,2,2,2,4,4,1,2024-01-05 11:14:00,0
5592,5592,5592,5592,2010,91,281,91,219,2010,62,91,200,199,198,91,91,281,62,31,31,7,91,7,7,7,7,7,2,2,2,2,1,1,0,2024-01-05 11:16:00,0
5650,5649,5649,5649,2036,97,278,96,210,2036,68,96,193,192,188,96,96,278,68,28,28,9,96,4,4,4,4,3,8,2,2,2,1,1,1,2024-01-05 11:18:00,0
5628,5628,5628,5628,2017,97,268,98,213,2017,55,98,195,188,188,98,98,268,55,28,28,4,98,4,4,4,4,4,0,2,2,2,7,7,0,2024-01-05 11:20:00,0
5583,5584,5584,5584,2018,88,305,88,261,2018,44,88,193,192,191,88,88,305,44,76,76,0,88,28,4,4,4,4,2,2,2,2,1,1,0,2024-01-05 11:22:00,72
5622,5622,5622,5622,2036,85,257,85,214,2036,43,85,201,198,197,85,85,257,43,31,31,0,85,7,7,7,7,7,2,2,2,2,3,3,0,2024-01-05 11:24:00,0
5629,5628,5628,5628,2035,108,254,108,207,2035,47,108,184,182,182,108,108,254,47,28,28,0,108,4,4,4,4,4,0,2,2,2,2,2,0,2024-01-05 11:26:00,0
5673,5673,5673,5673,2031,103,275,103,228,2031,47,103,196,193,190,103,103,275,47,28,28,0,103,4,4,4,4,3,6,2,2,2,3,3,1,2024-01-05 11:28:00,0
5620,5620,5620,5620,2032,104,244,104,206,2032,38,104,186,181,180,104,104,244,38,31,31,0,104,7,7,7,7,7,2,2,2,2,5,5,0,2024-01-05 11:30:00,0
5638,5638,5638,5638,2023,91,268,91,216,2023,52,91,196,193,191,91,91,268,52,27,27,0,91,3,3,3,3,3,4,2,2,2,3,3,0,2024-01-05 11:32:00,0
5637,5638,5638,5638,2035,91,280,91,217,2035,63,91,195,187,185,91,91,280,63,28,28,5,91,4,4,4,4,3,4,2,2,2,8,8,1,2024-01-05 11:34:00,0
5695,5695,5695,5695,2046,102,266,102,209,2046,57,102,203,200,199,102,102,266,57,28,28,1,102,4,4,4,4,4,2,2,2,2,3,3,0,2024-01-05 11:36:00,0
5583,5606,5583,5583,2008,93,274,93,212,2008,62,93,188,186,185,93,93,274,62,31,31,4,93,7,7,7,7,7,2,2,2,2,2,2,0,2024-01-05 11:38:00,0
5604,5603,5603,5603,2020,86,268,86,211,2020,57,86,191,187,184,86,86,268,57,28,28,0,86,4,4,4,4,4,6,2,2,2,4,4,0,2024-01-05 11:40:00,0
5630,5629,5629,5629,2008,87,281,87,209,2008,72,87,201,197,195,87,87,281,72,28,28,0,87,4,4,4,4,4,4,2,2,2,4,4,0,2024-01-05 11:42:00,0
5627,5629,5628,5628,2027,84,270,84,211,2027,59,84,189,187,186,84,84,270,59,28,28,0,84,4,4,4,4,3,2,2,2,2,2,2,1,2024-01-05 11:44:00,0
5661,5661,5661,5661,2040,97,283,97,214,2040,69,97,191,189,188,97,97,283,69,31,31,0,97,7,7,7,7,7,2,2,2,2,2,2,0,2024-01-05 11:46:00,0
5638,5638,5638,5638,2029,91,270,91,212,2029,58,91,195,193,192,91,91,270,58,27,27,0,91,3,3,3,3,3,2,2,2,2,2,2,0,2024-01-05 11:48:00,0
5638,5637,5637,5637,2027,93,318,93,211,2027,107,93,189,183,181,93,93,318,56,29,29,0,93,5,5,4,4,3,4,2,2,2,6,6,1,2024-01-05 11:50:00,52
5599,5601,5601,5601,2024,91,270,91,219,2024,51,91,180,178,177,91,91,270,51,32,32,0,91,8,8,8,8,8,2,2,2,2,2,2,0,2024-01-05 11:52:00,0
5620,5620,5620,5620,2020,93,267,93,207,2020,60,93,187,185,184,93,93,267,60,27,27,0,93,3,3,3,3,3,2,2,2,2,2,2,0,2024-01-05 11:54:00,0
5629,5628,5628,5628,2024,88,286,88,216,2024,70,88,182,180,179,88,88,286,70,28,28,0,88,4,4,4,4,4,2,2,2,2,2,2,0,2024-01-05 11:56:00,0
5663,5663,5663,5663,2027,96,289,96,216,2027,73,96,193,189,184,96,96,289,73,28,28,0,96,4,4,4,4,4,10,2,2,2,4,4,0,2024-01-05 11:58:00,0
5586,5586,5586,5586,2016,95,260,95,206,2016,54,95,188,182,181,95,95,260,54,31,31,4,95,7,7,7,7,6,2,2,2,2,6,6,1,2024-01-05 12:00:00,0
5533,5533,5533,5533,1981,86,355,86,202,1981,153,86,187,182,181,86,86,355,153,27,27,1,86,4,4,4,4,4,2,2,2,2,5,5,0,2024-01-05 12:02:00,0
5608,5609,5609,5609,2013,101,256,101,206,2013,50,101,190,188,188,101,101,256,50,28,28,0,101,4,4,4,4,3,0,2,2,2,2,2,1,2024-01-05 12:04:00,0
5652,5652,5651,5651,2020,91,279,90,207,2020,72,90,196,190,187,90,90,279,72,31,31,3,90,7,7,7,7,7,6,2,2,2,6,6,0,2024-01-05 12:06:00,0
5611,5612,5612,5612,2023,91,273,92,208,2023,65,92,201,196,194,92,92,273,65,28,28,1,92,4,4,4,4,4,4,2,2,2,5,5,0,2024-01-05 12:08:00,0
5696,5696,5696,5696,2033,106,278,106,215,2033,63,106,194,193,190,106,106,278,63,27,27,0,106,3,3,3,3,3,6,2,2,2,1,1,0,2024-01-05 12:10:00,0
5659,5659,5659,5659,2033,96,286,96,215,2033,71,96,192,189,188,96,96,286,71,28,28,4,96,4,4,4,4,4,2,2,2,2,3,3,0,2024-01-05 12:12:00,0
5646,5645,5645,5645,2023,97,276,97,218,2023,58,97,197,196,194,97,97,276,58,32,32,0,97,7,7,7,7,7,4,2,2,2,1,1,0,2024-01-05 12:14:00,0
5675,5674,5674,5674,2035,86,296,86,233,2035,63,86,190,185,184,86,86,296,63,28,28,0,86,4,4,4,4,3,2,2,2,2,5,5,1,2024-01-05 12:16:00,0
5661,5663,5663,5663,2038,101,278,101,219,2038,59,101,188,187,186,101,101,278,59,28,28,0,101,4,4,4,4,4,2,2,2,2,1,1,0,2024-01-05 12:18:00,0
5621,5621,5621,5621,2031,87,257,87,203,2031,54,87,189,187,186,87,87,257,54,28,28,0,87,4,4,4,4,3,2,2,2,2,2,2,1,2024-01-05 12:20:00,0
5626,5626,5626,5626,2013,88,287,88,225,2013,62,88,186,183,182,88,88,287,62,31,31,0,88,7,7,7,7,7,2,2,2,2,3,3,0,2024-01-05 12:22:00,0
5645,5642,5642,5642,2019,98,290,98,215,2019,75,98,191,187,184,98,98,290,75,28,28,0,98,4,4,4,4,4,6,2,2,2,4,4,0,2024-01-05 12:24:00,0
5588,5588,5588,5588,2006,99,256,99,203,2006,53,99,187,184,182,99,99,256,53,26,26,0,99,3,3,3,3,3,4,2,2,2,3,3,0,2024-01-05 12:26:00,0
5622,5623,5623,5623,2034,89,259,89,218,2034,41,89,182,179,179,89,89,259,41,32,32,0,89,8,8,8,8,8,0,2,2,2,3,3,0,2024-01-05 12:28:00,0
5614,5615,5615,5615,2029,87,247,87,211,2029,36,87,183,179,178,87,87,247,36,27,27,0,87,3,3,3,3,3,2,2,2,2,4,4,0,2024-01-05 12:30:00,0
5625,5624,5624,5624,2017,81,271,81,205,2017,66,81,202,201,197,81,81,271,66,28,28,0,81,4,4,4,4,3,8,2,2,2,1,1,1,2024-01-05 12:32:00,0
5669,5669,5669,5669,2028,106,285,105,213,2028,72,105,187,181,179,105,105,285,72,28,28,0,105,4,4,4,4,4,4,2,2,2,6,6,0,2024-01-05 12:34:00,0
5662,5664,5664,5664,2037,84,289,85,221,2037,68,85,192,188,187,85,85,289,68,31,31,0,85,7,7,7,7,6,2,2,2,2,4,4,1,2024-01-05 12:36:00,0
5642,5642,5642,5642,2033,81,262,81,211,2033,51,81,198,196,194,81,81,262,51,28,28,0,81,4,4,4,4,4,4,2,2,2,2,2,0,2024-01-05 12:38:00,0
5606,5605,5605,5605,2020,96,258,96,207,2020,51,96,190,188,188,96,96,258,51,28,28,0,96,4,4,4,4,4,0,2,2,2,2,2,0,2024-01-05 12:40:00,0
5614,5615,5615,5615,2013,87,286,87,208,2013,78,87,188,183,182,87,87,286,78,31,31,0,87,7,7,7,7,7,2,2,2,2,5,5,0,2024-01-05 12:42:00,0
5678,5677,5677,5677,2032,91,296,90,222,2032,74,90,198,195,192,90,90,296,74,28,28,0,90,4,4,4,4,4,6,2,2,2,3,3,0,2024-01-05 12:44:00,0
5626,5626,5626,5626,2027,85,266,86,214,2027,52,86,194,190,187,86,86,266,52,27,27,0,86,3,3,3,3,3,6,2,2,2,4,4,0,2024-01-05 12:46:00,0
5681,5682,5682,5682,2031,93,279,93,212,2031,67,93,207,200,199,93,93,279,67,28,28,0,93,4,4,4,4,3,2,2,2,2,7,7,1,2024-01-05 12:48:00,0
5593,5593,5593,5593,2019,91,326,91,217,2019,109,91,184,181,180,91,91,326,58,32,32,0,91,8,8,7,7,7,2,2,2,2,3,3,0,2024-01-05 12:50:00,52
5658,5658,5658,5658,2028,98,281,98,213,2028,68,98,182,180,178,98,98,281,68,28,28,4,98,4,4,4,4,3,4,2,2,2,2,2,1,2024-01-05 12:52:00,0
5655,5654,5654,5654,2029,91,283,91,214,2029,69,91,190,189,189,91,91,283,69,28,28,0,91,4,4,4,4,4,0,2,2,2,1,1,0,2024-01-05 12:54:00,0
5641,5642,5642,5642,2029,90,272,90,217,2029,55,90,192,191,188,90,90,272,55,28,28,0,90,4,4,4,4,4,6,2,2,2,1,1,0,2024-01-05 12:56:00,0
5644,5643,5643,5643,2024,98,287,98,222,2024,65,98,195,192,191,98,98,287,65,31,31,0,98,7,7,7,7,7,2,2,2,2,3,3,0,2024-01-05 12:58:00,0
5664,5665,5665,5665,2036,88,268,88,218,2036,50,88,185,180,179,88,88,268,50,28,28,0,88,4,4,4,4,4,2,2,2,2,5,5,0,2024-01-05 13:00:00,0
5659,5678,5656,5656,2021,109,376,109,219,2021,157,109,188,184,180,109,109,376,157,28,28,0,109,4,4,4,4,3,8,2,2,2,4,4,1,2024-01-05 13:02:00,0
5636,5638,5638,5638,2030,88,268,88,217,2030,51,88,201,194,191,88,88,268,51,31,31,0,88,7,7,7,7,7,6,2,2,2,7,7,0,2024-01-05 13:04:00,0
5636,5637,5637,5637,2026,98,266,98,199,2026,67,98,185,181,180,98,98,266,67,27,27,0,98,3,3,3,3,3,2,2,2,2,4,4,0,2024-01-05 13:06:00,0
5677,5677,5677,5677,2039,82,282,82,227,2039,55,82,186,185,182,82,82,282,55,28,28,4,82,4,4,4,4,3,6,2,2,2,1,1,1,2024-01-05 13:08:00,0
5635,5633,5633,5633,2029,98,263,98,206,2029,57,98,189,188,186,98,98,263,57,28,28,0,98,4,4,4,4,4,4,2,2,2,1,1,0,2024-01-05 13:10:00,0
5635,5636,5636,5636,2016,93,286,93,222,2016,64,93,198,195,194,93,93,286,64,31,31,0,93,7,7,7,7,7,2,2,2,2,3,3,0,2024-01-05 13:12:00,0
5576,5576,5576,5576,2008,85,279,85,214,2008,65,85,187,185,183,85,85,279,65,28,28,0,85,4,4,4,4,4,4,2,2,2,2,2,0,2024-01-05 13:14:00,0
5663,5662,5662,5662,2029,101,302,101,232,2029,70,101,189,187,185,101,101,302,70,28,28,0,101,4,4,4,4,4,4,2,2,2,2,2,0,2024-01-05 13:16:00,0
5646,5648,5648,5648,2023,83,288,83,220,2023,68,83,185,184,184,83,83,288,68,31,31,0,83,7,7,7,7,6,0,2,2,2,1,1,1,2024-01-05 13:18:00,0
5696,5694,5694,5694,2033,99,282,99,222,2033,60,99,201,197,196,99,99,282,60,28,28,0,99,4,4,4,4,4,2,2,2,2,4,4,0,2024-01-05 13:20:00,0
5614,5615,5615,5615,2013,93,269,93,220,2013,49,93,192,190,190,93,93,269,49,27,27,0,93,3,3,3,3,3,0,2,2,2,2,2,0,2024-01-05 13:22:00,0
5644,5644,5644,5644,2033,96,265,96,212,2033,53,96,184,183,183,96,96,265,53,28,28,0,96,4,4,4,4,3,0,2,2,2,1,1,1,2024-01-05 13:24:00,0
5620,5621,5621,5621,2024,96,261,96,212,2024,49,96,189,187,184,96,96,261,49,32,32,0,96,8,8,8,8,8,6,2,2,2,2,2,0,2024-01-05 13:26:00,0
5640,5640,5640,5640,2025,96,273,96,210,2025,63,96,185,182,181,96,96,273,63,27,27,0,96,3,3,3,3,3,2,2,2,2,3,3,0,2024-01-05 13:28:00,0
5672,5695,5672,5672,2038,85,279,85,217,2038,62,85,201,200,199,85,85,279,62,28,28,0,85,4,4,4,4,4,2,2,2,2,1,1,0,2024-01-05 13:30:00,0
5650,5648,5648,5648,2029,91,269,91,212,2029,57,91,188,183,182,91,91,269,57,28,28,0,91,4,4,4,4,4,2,2,2,2,5,5,0,2024-01-05 13:32:00,0
5605,5606,5606,5606,2018,89,286,89,223,2018,63,89,185,181,180,89,89,286,63,31,31,0,89,7,7,7,7,6,2,2,2,2,4,4,1,2024-01-05 13:34:00,0
5659,5660,5660,5660,2033,99,267,99,213,2033,54,99,195,193,190,99,99,267,54,28,28,0,99,4,4,4,4,4,6,2,2,2,2,2,0,2024-01-05 13:36:00,0
5602,5602,5602,5602,2007,91,276,91,215,2007,61,91,189,187,187,91,91,276,61,28,28,0,91,4,4,4,4,3,0,2,2,2,2,2,1,2024-01-05 13:38:00,0
5661,5661,5661,5661,2023,97,287,97,226,2023,61,97,196,194,192,97,97,287,61,31,31,0,97,7,7,7,7,7,4,2,2,2,2,2,0,2024-01-05 13:40:00,0
5653,5653,5653,5653,2022,97,272,97,205,2022,67,97,189,186,185,97,97,272,67,28,28,0,97,4,4,4,4,4,2,2,2,2,3,3,0,2024-01-05 13:42:00,0
5672,5672,5672,5672,2026,100,281,100,224,2026,57,100,193,191,187,100,100,281,57,27,27,0,100,3,3,3,3,3,8,2,2,2,2,2,0,2024-01-05 13:44:00,0
5651,5650,5650,5650,2018,96,293,96,214,2018,79,96,193,188,186,96,96,293,79,28,28,0,96,4,4,4,4,4,4,2,2,2,5,5,0,2024-01-05 13:46:00,0
5606,5605,5605,5605,2022,75,256,75,211,2022,45,75,187,182,182,75,75,256,45,31,31,0,75,7,7,7,7,7,0,2,2,2,5,5,0,2024-01-05 13:48:00,0
5618,5619,5619,5619,2016,99,327,98,219,2016,108,98,190,187,186,98,98,327,57,29,29,0,98,5,5,4,4,3,2,2,2,2,3,3,1,2024-01-05 13:50:00,52
5644,5646,5644,5644,2029,83,279,84,219,2029,60,84,199,195,192,84,84,279,60,28,28,0,84,4,4,4,4,4,6,2,2,2,4,4,0,2024-01-05 13:52:00,0
5632,5633,5633,5633,2026,85,270,85,213,2026,57,85,206,201,199,85,85,270,57,31,31,0,85,7,7,7,7,6,4,2,2,2,5,5,1,2024-01-05 13:54:00,0
5672,5674,5672,5672,2018,91,286,91,229,2018,57,91,196,191,190,91,91,286,57,28,28,0,91,4,4,4,4,4,2,2,2,2,5,5,0,2024-01-05 13:56:00,0
5649,5647,5647,5647,2035,90,273,90,216,2035,57,90,189,186,182,90,90,273,57,28,28,0,90,4,4,4,4,4,8,2,2,2,3,3,0,2024-01-05 13:58:00,0
5616,5616,5616,5616,2023,88,253,88,205,2023,48,88,197,194,194,88,88,253,48,27,27,0,88,3,3,3,3,3,0,2,2,2,3,3,0,2024-01-05 14:00:00,0
5640,5641,5641,5641,2020,93,370,93,214,2020,156,93,199,197,196,93,93,370,156,32,32,0,93,8,8,8,8,8,2,2,2,2,2,2,0,2024-01-05 14:02:00,0
5621,5624,5622,5622,2011,83,288,83,211,2011,77,83,196,191,189,83,83,288,77,27,27,0,83,3,3,3,3,3,4,2,2,2,5,5,0,2024-01-05 14:04:00,0
5631,5631,5631,5631,2023,105,266,105,212,2023,54,105,191,186,183,105,105,266,54,28,28,0,105,4,4,4,4,3,6,2,2,2,5,5,1,2024-01-05 14:06:00,0
5634,5634,5634,5634,2021,93,263,93,210,2021,53,93,205,200,199,93,93,263,53,28,28,0,93,4,4,4,4,4,2,2,2,2,5,5,0,2024-01-05 14:08:00,0
5616,5616,5616,5616,2026,82,278,82,209,2026,69,82,196,194,194,82,82,278,69,31,31,0,82,7,7,7,7,6,0,2,2,2,2,2,1,2024-01-05 14:10:00,0
5659,5658,5658,5658,2025,86,291,86,221,2025,70,86,194,192,192,86,86,291,70,28,28,0,86,4,4,4,4,4,0,2,2,2,2,2,0,2024-01-05 14:12:00,0
5638,5637,5637,5637,2021,88,288,88,218,2021,70,88,190,186,186,88,88,288,70,28,28,0,88,4,4,4,4,4,0,2,2,2,4,4,0,2024-01-05 14:14:00,0
5619,5620,5620,5620,2019,93,264,93,213,2019,51,93,191,185,183,93,93,264,51,31,31,0,93,7,7,7,7,7,4,2,2,2,6,6,0,2024-01-05 14:16:00,0
5643,5643,5643,5643,2026,93,274,93,216,2026,58,93,196,191,191,93,93,274,58,28,28,5,93,4,4,4,4,4,0,2,2,2,5,5,0,2024-01-05 14:18:00,0
5664,5664,5664,5664,2038,96,257,96,207,2038,50,96,189,185,182,96,96,257,50,27,27,0,96,3,3,3,3,3,6,2,2,2,4,4,0,2024-01-05 14:20:00,0
5620,5621,5621,5621,2016,77,290,77,216,2016,74,77,187,183,180,77,77,290,74,28,28,0,77,4,4,4,4,3,6,2,2,2,4,4,1,2024-01-05 14:22:00,0
5638,5637,5637,5637,2013,95,302,95,223,2013,79,95,191,191,189,95,95,302,79,31,31,0,95,7,7,7,7,7,4,2,2,2,0,0,0,2024-01-05 14:24:00,0
5620,5620,5620,5620,2020,101,258,101,212,2020,46,101,187,185,184,101,101,258,46,28,28,0,101,4,4,4,4,3,2,2,2,2,2,2,1,2024-01-05 14:26:00,0
5637,5637,5637,5637,2018,89,271,89,209,2018,62,89,185,183,180,89,89,271,62,28,28,0,89,4,4,4,4,4,6,2,2,2,2,2,0,2024-01-05 14:28:00,0
5618,5615,5615,5615,2024,89,279,89,229,2024,50,89,182,181,180,89,89,279,50,31,31,0,89,7,7,7,7,7,2,2,2,2,1,1,0,2024-01-05 14:30:00,0
5618,5618,5618,5618,2007,94,287,94,233,2007,54,94,188,187,186,94,94,287,54,34,34,0,94,7,4,4,4,4,2,2,2,2,1,1,0,2024-01-05 14:32:00,9
5664,5668,5668,5668,2005,95,309,95,217,2005,92,95,200,198,196,95,95,309,92,28,28,0,95,4,4,4,4,4,4,2,2,2,2,2,0,2024-01-05 14:34:00,0
5648,5647,5647,5647,2030,99,290,99,213,2030,77,99,191,185,183,99,99,290,77,34,34,0,99,4,4,4,4,3,4,2,2,2,6,6,1,2024-01-05 14:36:00,12
5620,5619,5619,5619,2015,77,301,77,214,2015,87,77,196,189,187,77,77,301,87,31,31,5,77,7,7,7,7,7,4,2,2,2,7,7,0,2024-01-05 14:38:00,0
5621,5623,5623,5623,2009,96,306,96,221,2009,85,96,186,184,184,96,96,306,85,29,29,3,96,4,3,3,3,3,0,2,2,2,2,2,0,2024-01-05 14:40:00,3
5562,5561,5561,5561,1991,91,266,91,208,1991,58,91,188,185,182,91,91,266,58,28,28,1,91,4,4,4,4,3,6,2,2,2,3,3,1,2024-01-05 14:42:00,0
5631,5631,5631,5631,2022,94,292,94,216,2022,76,94,188,184,182,94,94,292,76,36,36,0,94,8,4,4,4,4,4,2,2,2,4,4,0,2024-01-05 14:44:00,12
5637,5638,5638,5638,2025,80,300,80,221,2025,79,80,186,185,184,80,80,300,79,31,31,0,80,7,7,7,7,7,2,2,2,2,1,1,0,2024-01-05 14:46:00,0
5637,5636,5636,5636,2022,97,267,97,219,2022,48,97,196,191,188,97,97,267,48,28,28,0,97,4,4,4,4,4,6,2,2,2,5,5,0,2024-01-05 14:48:00,0
5610,5632,5609,5609,2008,88,321,88,213,2008,108,88,195,192,191,88,88,321,57,28,28,0,88,5,5,4,4,4,2,2,2,2,3,3,0,2024-01-05 14:50:00,52
5076,5078,5078,5078,1945,37,223,37,160,1945,63,37,129,129,129,37,37,223,63,31,31,0,37,7,7,7,7,6,0,2,2,2,0,0,1,2024-01-05 14:52:00,0
5198,5197,5197,5197,2031,24,213,24,146,2031,67,24,123,122,120,24,24,213,67,28,28,0,24,4,4,4,4,4,4,2,2,2,1,1,0,2024-01-05 14:54:00,0
5161,5161,5161,5161,2021,22,192,22,143,2021,49,22,126,122,118,22,22,192,49,27,27,0,22,3,3,3,3,3,8,2,2,2,4,4,0,2024-01-05 14:56:00,0
5202,5202,5202,5202,2038,24,200,24,146,2038,54,24,123,119,118,24,24,200,54,28,28,1,24,4,4,4,4,3,2,2,2,2,4,4,1,2024-01-05 14:58:00,0
5195,5196,5196,5196,2026,24,225,24,152,2026,73,24,124,121,119,24,24,225,73,35,35,7,24,9,8,8,8,8,4,2,2,2,3,3,0,2024-01-05 15:00:00,3
5181,5181,5180,5180,2021,24,407,24,145,2021,262,24,125,121,119,24,24,407,262,27,27,0,24,3,3,3,3,3,4,2,2,2,4,4,0,2024-01-05 15:02:00,0
5192,5193,5192,5192,2036,24,196,24,145,2036,51,24,123,120,118,24,24,196,51,28,28,0,24,4,4,4,4,4,4,2,2,2,3,3,0,2024-01-05 15:04:00,0
5165,5165,5165,5165,2024,24,196,24,145,2024,51,24,121,118,118,24,24,196,51,28,28,0,24,4,4,4,4,4,0,2,2,2,3,3,0,2024-01-05 15:06:00,0
5172,5173,5173,5173,2020,24,218,24,148,2020,70,24,119,118,118,24,24,218,70,31,31,0,24,7,7,7,7,6,0,2,2,2,1,1,1,2024-01-05 15:08:00,0
5179,5179,5179,5179,2026,24,207,24,145,2026,62,24,121,120,119,24,24,207,62,28,28,10,24,4,4,4,4,4,2,2,2,2,1,1,0,2024-01-05 15:10:00,0
5175,5174,5174,5174,2026,24,206,24,147,2026,59,24,122,119,119,24,24,206,59,30,30,0,24,5,4,4,4,3,0,2,2,2,3,3,1,2024-01-05 15:12:00,3
5127,5127,5127,5127,1995,24,229,24,152,1995,77,24,120,117,117,24,24,229,77,36,36,0,24,10,7,7,7,7,0,2,2,2,3,3,0,2024-01-05 15:14:00,9
5173,5172,5172,5172,2018,24,211,24,145,2018,66,24,127,117,117,24,24,211,66,28,28,0,24,4,4,4,4,4,0,2,2,2,10,10,0,2024-01-05 15:16:00,0
5169,5171,5171,5171,2020,24,203,24,144,2020,59,24,125,120,118,24,24,203,59,27,27,0,24,3,3,3,3,3,4,2,2,2,5,5,0,2024-01-05 15:18:00,0
5200,5200,5200,5200,2033,22,212,22,146,2033,66,22,127,123,119,22,22,212,66,28,28,0,22,4,4,4,4,4,8,2,2,2,4,4,0,2024-01-05 15:20:00,0
5185,5184,5184,5184,2024,24,216,24,149,2024,67,24,123,120,118,24,24,216,67,31,31,0,24,7,7,7,7,7,4,2,2,2,3,3,0,2024-01-05 15:22:00,0
5171,5172,5172,5172,2025,24,205,24,145,2025,60,24,121,119,118,24,24,205,60,28,28,0,24,4,4,4,4,3,2,2,2,2,2,2,1,2024-01-05 15:24:00,0
5185,5185,5185,5185,2023,24,215,24,145,2023,70,24,124,119,118,24,24,215,70,28,28,0,24,4,4,4,4,4,2,2,2,2,5,5,0,2024-01-05 15:26:00,0
5201,5200,5200,5200,2036,24,203,24,146,2036,57,24,126,122,119,24,24,203,57,28,28,0,24,4,4,4,4,3,6,2,2,2,4,4,1,2024-01-05 15:28:00,0
5158,5158,5158,5158,2022,24,195,24,148,2022,47,24,119,119,118,24,24,195,47,31,31,0,24,7,7,7,7,7,2,2,2,2,0,0,0,2024-01-05 15:30:00,0
5179,5180,5180,5180,2024,24,212,24,145,2024,67,24,122,120,118,24,24,212,67,28,28,0,24,4,4,4,4,4,4,2,2,2,2,2,0,2024-01-05 15:32:00,0
5172,5172,5172,5172,2025,24,205,24,147,2025,58,24,120,118,118,24,24,205,58,29,29,0,24,4,3,3,3,3,0,2,2,2,2,2,0,2024-01-05 15:34:00,3
5210,5210,5210,5210,2032,24,223,24,149,2032,74,24,127,123,121,24,24,223,74,32,32,0,24,8,8,8,8,8,4,2,2,2,4,4,0,2024-01-05 15:36:00,0
5152,5152,5151,5151,2017,24,204,24,144,2017,60,24,120,119,117,24,24,204,60,27,27,0,24,3,3,3,3,3,4,2,2,2,1,1,0,2024-01-05 15:38:00,0
5176,5177,5177,5177,2022,24,204,24,145,2022,59,24,127,121,119,24,24,204,59,28,28,0,24,4,4,4,4,3,4,2,2,2,6,6,1,2024-01-05 15:40:00,0
5168,5189,5167,5167,2013,24,220,24,145,2013,75,24,122,118,118,24,24,220,75,28,28,0,24,4,4,4,4,4,0,2,2,2,4,4,0,2024-01-05 15:42:00,0
5199,5221,5199,5199,2031,24,214,24,149,2031,65,24,124,120,119,24,24,214,65,31,31,0,24,7,7,7,7,6,2,2,2,2,4,4,1,2024-01-05 15:44:00,0
5188,5189,5189,5189,2027,22,213,22,145,2027,68,22,123,121,118,22,22,213,68,28,28,0,22,4,4,4,4,4,6,2,2,2,2,2,0,2024-01-05 15:46:00,0
5193,5212,5193,5193,2029,24,204,24,146,2029,58,24,127,119,119,24,24,204,58,28,28,0,24,4,4,4,4,4,0,2,2,2,8,8,0,2024-01-05 15:48:00,0
5183,5183,5183,5183,2021,24,271,24,148,2021,123,24,125,122,118,24,24,271,72,32,32,0,24,8,8,7,7,7,8,2,2,2,3,3,0,2024-01-05 15:50:00,52
5190,5190,5190,5190,2028,24,206,24,146,2028,60,24,126,121,119,24,24,206,60,28,28,0,24,4,4,4,4,4,4,2,2,2,5,5,0,2024-01-05 15:52:00,0
5199,5199,5199,5199,2034,24,206,24,144,2034,62,24,126,122,118,24,24,206,62,27,27,0,24,3,3,3,3,3,8,2,2,2,4,4,0,2024-01-05 15:54:00,0
5192,5192,5192,5192,2020,24,221,24,145,2020,76,24,128,122,118,24,24,221,76,28,28,0,24,4,4,4,4,3,8,2,2,2,6,6,1,2024-01-05 15:56:00,0
5183,5183,5183,5183,2019,24,224,24,148,2019,76,24,124,121,118,24,24,224,76,31,31,0,24,7,7,7,7,7,6,2,2,2,3,3,0,2024-01-05 15:58:00,0
5189,5189,5189,5189,2029,24,205,24,145,2029,60,24,123,120,118,24,24,205,60,28,28,0,24,4,4,4,4,3,4,2,2,2,3,3,1,2024-01-05 16:00:00,0
5129,5127,5127,5127,2000,24,208,24,145,2000,63,24,123,120,119,24,24,208,63,28,28,5,24,4,4,4,4,4,2,2,2,2,3,3,0,2024-01-05 16:02:00,0
5215,5235,5216,5216,2044,24,208,24,146,2044,62,24,122,121,119,24,24,208,62,28,28,0,24,4,4,4,4,4,4,2,2,2,1,1,0,2024-01-05 16:04:00,0
5222,5223,5223,5223,2035,24,234,24,149,2035,85,24,126,120,119,24,24,234,85,31,31,0,24,7,7,7,7,7,2,2,2,2,6,6,0,2024-01-05 16:06:00,0
5191,5191,5191,5191,2024,24,211,24,144,2024,67,24,126,119,118,24,24,211,67,28,28,0,24,4,4,4,4,4,2,2,2,2,7,7,0,2024-01-05 16:08:00,0
5197,5197,5197,5197,2032,24,209,24,146,2032,63,24,127,120,119,24,24,209,63,28,28,0,24,4,4,4,4,3,2,2,2,2,7,7,1,2024-01-05 16:10:00,0
5183,5182,5182,5182,2028,22,212,22,148,2028,64,22,120,119,118,22,22,212,64,31,31,0,22,7,7,7,7,7,2,2,2,2,1,1,0,2024-01-05 16:12:00,0
5197,5198,5198,5198,2030,24,209,24,144,2030,65,24,129,122,120,24,24,209,65,27,27,0,24,3,3,3,3,3,4,2,2,2,7,7,0,2024-01-05 16:14:00,0
5166,5166,5166,5166,2019,24,209,24,145,2019,64,24,124,120,118,24,24,209,64,28,28,0,24,4,4,4,4,3,4,2,2,2,4,4,1,2024-01-05 16:16:00,0
5201,5200,5200,5200,2031,24,209,24,145,2031,64,24,127,124,118,24,24,209,64,28,28,0,24,4,4,4,4,4,12,2,2,2,3,3,0,2024-01-05 16:18:00,0
5173,5174,5174,5174,2018,24,212,24,148,2018,64,24,127,121,118,24,24,212,64,31,31,0,24,7,7,7,7,7,6,2,2,2,6,6,0,2024-01-05 16:20:00,0
5169,5168,5168,5168,2016,24,209,24,145,2016,64,24,125,121,118,24,24,209,64,28,28,0,24,4,4,4,4,4,6,2,2,2,4,4,0,2024-01-05 16:22:00,0
5182,5183,5183,5183,2029,24,205,24,145,2029,60,24,121,119,119,24,24,205,60,28,28,0,24,4,4,4,4,4,0,2,2,2,2,2,0,2024-01-05 16:24:00,0
5112,5112,5112,5112,1999,24,200,24,144,1999,56,24,122,118,118,24,24,200,56,28,28,0,24,4,4,4,4,3,0,2,2,2,4,4,1,2024-01-05 16:26:00,0
5169,5169,5169,5169,2025,24,200,24,150,2025,50,24,122,119,118,24,24,200,50,33,33,0,24,8,7,7,7,7,2,2,2,2,3,3,0,2024-01-05 16:28:00,3
5173,5173,5173,5173,2025,24,199,24,144,2025,55,24,123,122,119,24,24,199,55,27,27,4,24,3,3,3,3,3,6,2,2,2,1,1,0,2024-01-05 16:30:00,0
5162,5162,5162,5162,2020,24,198,24,145,2020,53,24,123,120,118,24,24,198,53,28,28,0,24,4,4,4,4,3,4,2,2,2,3,3,1,2024-01-05 16:32:00,0
5174,5171,5171,5171,2029,24,197,24,149,2029,48,24,121,118,118,24,24,197,48,32,32,0,24,8,8,8,8,8,0,2,2,2,3,3,0,2024-01-05 16:34:00,0
5155,5158,5158,5158,2019,22,194,22,144,2019,50,22,121,118,118,22,22,194,50,27,27,0,22,3,3,3,3,3,0,2,2,2,3,3,0,2024-01-05 16:36:00,0
5203,5203,5203,5203,2036,24,210,24,145,2036,65,24,124,118,118,24,24,210,65,28,28,0,24,4,4,4,4,4,0,2,2,2,6,6,0,2024-01-05 16:38:00,0
5185,5184,5184,5184,2030,24,202,24,145,2030,57,24,125,121,119,24,24,202,57,28,28,0,24,4,4,4,4,4,4,2,2,2,4,4,0,2024-01-05 16:40:00,0
5205,5206,5206,5206,2024,24,235,24,149,2024,86,24,124,121,118,24,24,235,86,31,31,0,24,7,7,7,7,6,6,2,2,2,3,3,1,2024-01-05 16:42:00,0
5198,5197,5197,5197,2037,24,201,24,146,2037,55,24,123,120,119,24,24,201,55,28,28,12,24,4,4,4,4,4,2,2,2,2,3,3,0,2024-01-05 16:44:00,0
5170,5171,5171,5171,2022,24,204,24,145,2022,59,24,124,119,118,24,24,204,59,28,28,0,24,4,4,4,4,3,2,2,2,2,5,5,1,2024-01-05 16:46:00,0
5165,5165,5165,5165,2024,24,196,24,148,2024,48,24,121,120,118,24,24,196,48,31,31,0,24,7,7,7,7,7,4,2,2,2,1,1,0,2024-01-05 16:48:00,0
5143,5143,5143,5143,2012,24,256,24,145,2012,111,24,122,118,118,24,24,256,60,29,29,0,24,5,5,4,4,4,0,2,2,2,4,4,0,2024-01-05 16:50:00,52
5908,5909,5909,5909,2319,26,277,26,218,2319,59,26,138,136,135,26,26,277,59,84,83,0,26,29,3,3,3,3,2,3,3,3,2,2,0,2024-01-05 16:52:00,81
5195,5194,5194,5194,2034,24,306,24,250,2034,56,24,126,123,120,24,24,306,56,132,133,0,24,57,4,4,4,4,6,2,2,2,3,3,0,2024-01-05 16:54:00,156
5198,5199,5199,5199,2030,24,215,24,149,2030,66,24,123,119,118,24,24,215,66,31,31,9,24,7,7,7,7,7,2,2,2,2,4,4,0,2024-01-05 16:56:00,0
5146,5146,5146,5146,2006,24,217,24,144,2006,73,24,123,119,117,24,24,217,73,28,28,11,24,4,4,4,4,3,4,2,2,2,4,4,1,2024-01-05 16:58:00,0
5184,5183,5183,5183,2025,24,208,24,145,2025,63,24,127,121,119,24,24,208,63,28,28,0,24,4,4,4,4,4,4,2,2,2,6,6,0,2024-01-05 17:00:00,0
5153,5153,5153,5153,2009,22,211,22,144,2009,67,22,121,120,118,22,22,211,67,28,28,13,22,4,4,4,4,3,4,2,2,2,1,1,1,2024-01-05 17:02:00,0
5192,5214,5193,5193,2030,24,217,24,149,2030,68,24,123,120,119,24,24,217,68,31,31,1,24,7,7,7,7,7,2,2,2,2,3,3,0,2024-01-05 17:04:00,0
5158,5168,5158,5158,2021,24,191,24,145,2021,46,24,120,118,118,24,24,191,46,28,28,0,24,4,4,4,4,4,0,2,2,2,2,2,0,2024-01-05 17:06:00,0
5164,5166,5164,5164,2022,24,197,24,144,2022,53,24,123,121,118,24,24,197,53,27,27,0,24,3,3,3,3,3,6,2,2,2,2,2,0,2024-01-05 17:08:00,0
5150,5150,5150,5150,2018,24,187,24,144,2018,43,24,122,118,118,24,24,187,43,28,28,0,24,4,4,4,4,4,0,2,2,2,4,4,0,2024-01-05 17:10:00,0
5189,5189,5189,5189,2029,24,214,24,149,2029,65,24,123,119,119,24,24,214,65,31,31,0,24,7,7,7,7,7,0,2,2,2,4,4,0,2024-01-05 17:12:00,0
5187,5186,5186,5186,2026,24,210,24,144,2026,66,24,126,121,119,24,24,210,66,28,28,0,24,4,4,4,4,3,4,2,2,2,5,5,1,2024-01-05 17:14:00,0
5195,5200,5196,5196,2027,24,214,24,146,2027,68,24,127,120,118,24,24,214,68,28,28,0,24,4,4,4,4,4,4,2,2,2,7,7,0,2024-01-05 17:16:00,0
5195,5195,5195,5195,2030,24,212,24,148,2030,64,24,126,122,119,24,24,212,64,31,31,4,24,7,7,7,7,6,6,2,2,2,4,4,1,2024-01-05 17:18:00,0
5107,5107,5107,5107,2004,24,182,24,144,2004,38,24,122,119,117,24,24,182,38,28,28,0,24,4,4,4,4,4,4,2,2,2,3,3,0,2024-01-05 17:20:00,0
5175,5175,5175,5175,2015,24,214,24,145,2015,69,24,126,121,118,24,24,214,69,28,28,0,24,4,4,4,4,4,6,2,2,2,5,5,0,2024-01-05 17:22:00,0
5181,5180,5180,5180,2031,24,189,24,144,2031,45,24,126,120,119,24,24,189,45,27,27,0,24,3,3,3,3,3,2,2,2,2,6,6,0,2024-01-05 17:24:00,0
5208,5208,5208,5208,2034,24,221,24,150,2034,71,24,120,118,118,24,24,221,71,32,32,0,24,8,8,8,8,8,0,2,2,2,2,2,0,2024-01-05 17:26:00,0
5187,5188,5188,5188,2030,22,203,22,144,2030,59,22,124,121,119,22,22,203,59,27,27,0,22,3,3,3,3,3,4,2,2,2,3,3,0,2024-01-05 17:28:00,0
5184,5184,5184,5184,2030,24,195,24,145,2030,50,24,124,121,118,24,24,195,50,28,28,0,24,4,4,4,4,3,6,2,2,2,3,3,1,2024-01-05 17:30:00,0
5174,5172,5172,5172,2032,24,186,24,146,2032,40,24,122,118,118,24,24,186,40,28,28,4,24,4,4,4,4,4,0,2,2,2,4,4,0,2024-01-05 17:32:00,0
5187,5189,5189,5189,2033,24,200,24,149,2033,51,24,123,121,119,24,24,200,51,31,31,0,24,7,7,7,7,6,4,2,2,2,2,2,1,2024-01-05 17:34:00,0
5168,5188,5167,5167,2023,24,198,24,147,2023,51,24,123,121,119,24,24,198,51,30,30,0,24,5,4,4,4,4,4,2,2,2,2,2,0,2024-01-05 17:36:00,3
5225,5229,5225,5225,2030,24,239,24,145,2030,94,24,121,119,118,24,24,239,94,28,28,0,24,4,4,4,4,4,2,2,2,2,2,2,0,2024-01-05 17:38:00,0
5203,5204,5204,5204,2040,24,212,24,151,2040,61,24,122,121,119,24,24,212,61,33,33,0,24,8,7,7,7,7,4,2,2,2,1,1,0,2024-01-05 17:40:00,3
5159,5159,5159,5159,2016,24,197,24,145,2016,52,24,126,119,118,24,24,197,52,28,28,0,24,4,4,4,4,4,2,2,2,2,7,7,0,2024-01-05 17:42:00,0
5123,5123,5123,5123,2004,24,198,24,142,2004,56,24,121,117,117,24,24,198,56,26,26,0,24,3,3,3,3,3,0,2,2,2,4,4,0,2024-01-05 17:44:00,0
5166,5166,5166,5166,2013,24,211,24,144,2013,67,24,124,121,118,24,24,211,67,28,28,0,24,4,4,4,4,3,6,2,2,2,3,3,1,2024-01-05 17:46:00,0
5191,5190,5190,5190,2025,24,220,24,148,2025,72,24,123,122,118,24,24,220,72,31,31,10,24,7,7,7,7,7,8,2,2,2,1,1,0,2024-01-05 17:48:00,0
5204,5205,5205,5205,2037,24,258,24,147,2037,111,24,123,121,119,24,24,258,60,29,29,0,24,5,5,4,4,3,4,2,2,2,2,2,1,2024-01-05 17:50:00,52
5188,5188,5188,5188,2024,24,214,24,145,2024,69,24,124,121,118,24,24,214,69,28,28,0,24,4,4,4,4,4,6,2,2,2,3,3,0,2024-01-05 17:52:00,0
5197,5196,5196,5196,2033,24,210,23,146,2033,64,23,122,120,119,23,23,210,64,28,28,0,23,4,4,4,4,4,2,2,2,2,2,2,0,2024-01-05 17:54:00,0
5193,5194,5194,5194,2033,22,215,23,148,2033,67,23,119,118,118,23,23,215,67,31,31,0,23,7,7,7,7,7,0,2,2,2,1,1,0,2024-01-05 17:56:00,0
5186,5186,5186,5186,2024,24,219,24,145,2024,74,24,119,118,118,24,24,219,74,28,28,0,24,4,4,4,4,4,0,2,2,2,1,1,0,2024-01-05 17:58:00,0
5147,5146,5146,5146,2010,24,202,24,145,2010,57,24,119,118,118,24,24,202,57,28,28,0,24,4,4,4,4,3,0,2,2,2,1,1,1,2024-01-05 18:00:00,0
5142,5142,5142,5142,2003,24,410,24,143,2003,267,24,119,118,118,24,24,410,267,27,27,0,24,3,3,3,3,3,0,2,2,2,1,1,0,2024-01-05 18:02:00,0
5143,5144,5144,5144,2013,24,195,24,148,2013,47,24,125,120,117,24,24,195,47,31,31,0,24,7,7,7,7,7,6,2,2,2,5,5,0,2024-01-05 18:04:00,0
5192,5192,5192,5192,2031,24,206,24,145,2031,61,24,124,123,119,24,24,206,61,28,28,0,24,4,4,4,4,3,8,2,2,2,1,1,1,2024-01-05 18:06:00,0
5182,5182,5182,5182,2033,24,201,24,146,2033,55,24,119,119,118,24,24,201,55,29,29,0,24,4,4,4,4,4,2,2,2,2,0,0,0,2024-01-05 18:08:00,0
5135,5136,5135,5135,2010,24,200,24,147,2010,53,24,123,118,117,24,24,200,53,30,30,0,24,7,7,7,7,7,2,2,2,2,5,5,0,2024-01-05 18:10:00,0
5176,5176,5176,5176,2017,24,212,24,144,2017,68,24,125,120,119,24,24,212,68,28,28,0,24,4,4,4,4,4,2,2,2,2,5,5,0,2024-01-05 18:12:00,0
5212,5233,5211,5211,2035,24,221,24,146,2035,75,24,121,120,119,24,24,221,75,28,28,0,24,4,4,4,4,4,2,2,2,2,1,1,0,2024-01-05 18:14:00,0
5197,5197,5197,5197,2030,24,211,24,145,2030,66,24,123,118,118,24,24,211,66,28,28,0,24,4,4,4,4,3,0,2,2,2,5,5,1,2024-01-05 18:16:00,0
5186,5189,5187,5187,2027,24,213,24,148,2027,65,24,122,119,118,24,24,213,65,31,31,0,24,7,7,7,7,7,2,2,2,2,3,3,0,2024-01-05 18:18:00,0
5176,5178,5176,5176,2030,24,198,24,145,2030,53,24,121,119,118,24,24,198,53,27,27,0,24,3,3,3,3,3,2,2,2,2,2,2,0,2024-01-05 18:20:00,2
5177,5177,5177,5177,2018,22,215,22,145,2018,70,22,123,118,118,22,22,215,70,28,28,0,22,4,4,4,4,3,0,2,2,2,5,5,1,2024-01-05 18:22:00,0
5193,5193,5193,5193,2033,24,202,24,146,2033,56,24,125,120,119,24,24,202,56,28,28,0,24,4,4,4,4,4,2,2,2,2,5,5,0,2024-01-05 18:24:00,0
5212,5211,5211,5211,2031,24,228,24,148,2031,80,24,123,122,119,24,24,228,80,31,31,0,24,7,7,7,7,7,6,2,2,2,1,1,0,2024-01-05 18:26:00,0
5166,5167,5167,5167,2017,24,205,24,145,2017,60,24,123,120,118,24,24,205,60,28,28,0,24,4,4,4,4,4,4,2,2,2,3,3,0,2024-01-05 18:28:00,0
5197,5197,5197,5197,2030,24,210,24,146,2030,64,24,124,121,119,24,24,210,64,28,28,0,24,4,4,4,4,4,4,2,2,2,3,3,0,2024-01-05 18:30:00,0
5129,5129,5129,5129,2009,24,207,24,147,2009,60,24,119,118,117,24,24,207,60,31,31,10,24,7,7,7,7,6,2,2,2,2,1,1,1,2024-01-05 18:32:00,0
5150,5149,5149,5149,2020,24,183,24,144,2020,39,24,121,120,118,24,24,183,39,28,28,0,24,4,4,4,4,4,4,2,2,2,1,1,0,2024-01-05 18:34:00,0
5198,5196,5196,5196,2037,24,200,24,145,2037,55,24,122,120,119,24,24,200,55,27,27,0,24,3,3,3,3,3,2,2,2,2,2,2,0,2024-01-05 18:36:00,0
5177,5180,5180,5180,2027,24,199,24,145,2027,54,24,124,123,120,24,24,199,54,28,28,0,24,4,4,4,4,3,6,2,2,2,1,1,1,2024-01-05 18:38:00,0
5210,5210,5210,5210,2042,24,212,24,150,2042,62,24,120,119,118,24,24,212,62,32,32,0,24,8,8,8,8,8,2,2,2,2,1,1,0,2024-01-05 18:40:00,0
5195,5195,5195,5195,2023,24,222,24,145,2023,77,24,123,120,119,24,24,222,77,27,27,0,24,3,3,3,3,3,2,2,2,2,3,3,0,2024-01-05 18:42:00,0
5171,5170,5170,5170,2020,24,209,24,144,2020,65,24,122,119,118,24,24,209,65,28,28,0,24,4,4,4,4,4,2,2,2,2,3,3,0,2024-01-05 18:44:00,0
5183,5182,5182,5182,2023,24,206,24,146,2023,60,24,125,119,118,24,24,206,60,28,28,0,24,4,4,4,4,4,2,2,2,2,6,6,0,2024-01-05 18:46:00,0
5182,5184,5184,5184,2015,22,234,22,147,2015,87,22,125,120,119,22,22,234,87,31,31,0,22,7,7,7,7,6,2,2,2,2,5,5,1,2024-01-05 18:48:00,0
5196,5196,5196,5196,2035,24,254,24,147,2035,107,24,121,119,119,24,24,254,56,29,29,0,24,5,5,4,4,4,0,2,2,2,2,2,0,2024-01-05 18:50:00,52
5177,5197,5176,5176,2029,24,194,24,145,2029,49,24,123,120,119,24,24,194,49,28,28,0,24,4,4,4,4,3,2,2,2,2,3,3,1,2024-01-05 18:52:00,0
5183,5184,5184,5184,2026,24,213,24,148,2026,65,24,122,119,118,24,24,213,65,31,31,0,24,7,7,7,7,7,2,2,2,2,3,3,0,2024-01-05 18:54:00,0
5181,5181,5181,5181,2024,24,204,24,145,2024,59,24,126,123,119,24,24,204,59,28,28,0,24,4,4,4,4,4,8,2,2,2,3,3,0,2024-01-05 18:56:00,0
5143,5144,5142,5142,2004,24,218,24,143,2004,75,24,120,117,117,24,24,218,75,27,27,0,24,3,3,3,3,3,0,2,2,2,3,3,0,2024-01-05 18:58:00,0
5175,5176,5176,5176,2026,24,200,24,145,2026,55,24,121,118,118,24,24,200,55,28,28,0,24,4,4,4,4,4,0,2,2,2,3,3,0,2024-01-05 19:00:00,0
5173,5173,5173,5173,2016,24,218,24,148,2016,70,24,123,121,118,24,24,218,70,31,31,0,24,7,7,7,7,7,6,2,2,2,2,2,0,2024-01-05 19:02:00,0
5216,5216,5216,5216,2036,24,227,24,152,2036,75,24,122,121,119,24,24,227,75,34,34,0,24,7,4,4,4,3,4,2,2,2,1,1,1,2024-01-05 19:04:00,9
5174,5172,5172,5172,2023,24,205,24,145,2023,60,24,122,120,119,24,24,205,60,28,28,0,24,4,4,4,4,4,2,2,2,2,2,2,0,2024-01-05 19:06:00,0
5173,5175,5175,5175,2022,24,201,24,145,2022,56,24,121,119,118,24,24,201,56,28,28,0,24,4,4,4,4,3,2,2,2,2,2,2,1,2024-01-05 19:08:00,0
5177,5177,5177,5177,2028,24,208,24,148,2028,60,24,122,119,118,24,24,208,60,31,31,0,24,7,7,7,7,7,2,2,2,2,3,3,0,2024-01-05 19:10:00,0
5204,5202,5202,5202,2028,24,225,24,145,2028,80,24,123,121,119,24,24,225,80,28,28,10,24,4,4,4,4,4,4,2,2,2,2,2,0,2024-01-05 19:12:00,0
5200,5202,5202,5202,2026,22,222,22,144,2026,78,22,126,122,119,22,22,222,78,27,27,10,22,3,3,3,3,3,6,2,2,2,4,4,0,2024-01-05 19:14:00,0
5176,5175,5175,5175,2028,24,201,24,149,2028,52,24,121,119,118,24,24,201,52,32,32,0,24,8,8,8,8,8,2,2,2,2,2,2,0,2024-01-05 19:16:00,0
5192,5193,5193,5193,2026,24,210,24,144,2026,66,24,128,122,118,24,24,210,66,27,27,0,24,3,3,3,3,3,8,2,2,2,6,6,0,2024-01-05 19:18:00,0
5203,5203,5203,5203,2031,24,215,24,145,2031,70,24,127,121,120,24,24,215,70,28,28,16,24,4,4,4,4,3,2,2,2,2,6,6,1,2024-01-05 19:20:00,0
5140,5139,5139,5139,2007,24,203,24,145,2007,58,24,126,121,118,24,24,203,58,28,28,0,24,4,4,4,4,4,6,2,2,2,5,5,0,2024-01-05 19:22:00,0
5203,5202,5202,5202,2037,24,213,24,148,2037,65,24,121,119,118,24,24,213,65,31,31,0,24,7,7,7,7,6,2,2,2,2,2,2,1,2024-01-05 19:24:00,0
5200,5203,5202,5202,2033,24,214,24,146,2033,68,24,123,120,119,24,24,214,68,28,28,0,24,4,4,4,4,4,2,2,2,2,3,3,0,2024-01-05 19:26:00,0
5178,5178,5178,5178,2017,24,217,24,145,2017,72,24,121,121,118,24,24,217,72,28,28,0,24,4,4,4,4,4,6,2,2,2,0,0,0,2024-01-05 19:28:00,0
5161,5160,5160,5160,2020,24,194,24,144,2020,50,24,121,118,118,24,24,194,50,27,27,0,24,3,3,3,3,3,0,2,2,2,3,3,0,2024-01-05 19:30:00,0
5164,5165,5165,5165,2022,24,199,24,149,2022,50,24,125,118,118,24,24,199,50,32,32,0,24,8,8,8,8,8,0,2,2,2,7,7,0,2024-01-05 19:32:00,0
5191,5190,5190,5190,2031,24,201,24,144,2031,57,24,126,121,118,24,24,201,57,27,27,0,24,3,3,3,3,3,6,2,2,2,5,5,0,2024-01-05 19:34:00,0
5183,5184,5184,5184,2022,24,221,24,145,2022,76,24,121,120,119,24,24,221,76,28,28,3,24,4,4,4,4,3,2,2,2,2,1,1,1,2024-01-05 19:36:00,0
5173,5171,5171,5171,2030,24,192,24,148,2030,44,24,124,120,118,24,24,192,44,31,31,0,24,7,7,7,7,7,4,2,2,2,4,4,0,2024-01-05 19:38:00,0
5199,5200,5200,5200,2028,24,216,23,145,2028,71,23,123,120,119,23,23,216,71,28,28,0,23,4,4,4,4,3,2,2,2,2,3,3,1,2024-01-05 19:40:00,0
5165,5166,5166,5166,2020,22,205,23,146,2020,59,23,120,119,118,23,23,205,59,28,28,0,23,4,4,4,4,4,2,2,2,2,1,1,0,2024-01-05 19:42:00,0
5166,5166,5166,5166,2019,24,201,24,144,2019,57,24,120,119,118,24,24,201,57,28,28,0,24,4,4,4,4,4,2,2,2,2,1,1,0,2024-01-05 19:44:00,0
5140,5139,5139,5139,2008,24,213,24,147,2008,66,24,119,117,117,24,24,213,66,31,31,0,24,7,7,7,7,7,0,2,2,2,2,2,0,2024-01-05 19:46:00,0
5180,5181,5181,5181,2029,24,200,24,146,2029,54,24,126,121,119,24,24,200,54,28,28,0,24,4,4,4,4,4,4,2,2,2,5,5,0,2024-01-05 19:48:00,0
5165,5165,5164,5164,2025,24,240,24,145,2025,95,24,120,118,118,24,24,240,44,28,28,0,24,4,4,3,3,3,0,2,2,2,2,2,0,2024-01-05 19:50:00,52
5200,5201,5201,5201,2029,24,208,24,145,2029,63,24,127,120,118,24,24,208,63,28,28,0,24,4,4,4,4,3,4,2,2,2,7,7,1,2024-01-05 19:52:00,0
5192,5192,5192,5192,2027,24,215,24,148,2027,67,24,125,121,119,24,24,215,67,31,31,0,24,7,7,7,7,7,4,2,2,2,4,4,0,2024-01-05 19:54:00,0
5167,5166,5166,5166,2022,24,197,24,145,2022,52,24,121,120,118,24,24,197,52,28,28,0,24,4,4,4,4,3,4,2,2,2,1,1,1,2024-01-05 19:56:00,0
5202,5203,5203,5203,2029,24,217,24,146,2029,71,24,124,122,118,24,24,217,71,28,28,4,24,4,4,4,4,4,8,2,2,2,2,2,0,2024-01-05 19:58:00,0
5179,5179,5179,5179,2033,24,196,24,148,2033,48,24,123,121,119,24,24,196,48,31,31,0,24,7,7,7,7,7,4,2,2,2,2,2,0,2024-01-05 20:00:00,0
5164,5163,5163,5163,2010,24,317,24,145,2010,172,24,123,119,118,24,24,317,172,28,28,0,24,4,4,4,4,4,2,2,2,2,4,4,0,2024-01-05 20:02:00,0
5208,5209,5209,5209,2037,24,212,24,146,2037,66,24,123,120,119,24,24,212,66,28,28,0,24,4,4,4,4,4,2,2,2,2,3,3,0,2024-01-05 20:04:00,0
5159,5158,5158,5158,2023,24,189,24,145,2023,44,24,124,120,118,24,24,189,44,28,28,0,24,4,4,4,4,3,4,2,2,2,4,4,1,2024-01-05 20:06:00,0
5173,5174,5174,5174,2031,22,195,22,148,2031,47,22,122,120,118,22,22,195,47,31,31,0,22,7,7,7,7,7,4,2,2,2,2,2,0,2024-01-05 20:08:00,0
5144,5144,5144,5144,2006,24,210,24,143,2006,67,24,125,121,118,24,24,210,67,27,27,0,24,3,3,3,3,3,6,2,2,2,4,4,0,2024-01-05 20:10:00,0
5212,5212,5211,5211,2027,24,235,24,145,2027,90,24,124,120,119,24,24,235,90,28,28,0,24,4,4,4,4,3,2,2,2,2,4,4,1,2024-01-05 20:12:00,0
5180,5179,5179,5179,2028,24,202,24,146,2028,56,24,121,121,118,24,24,202,56,28,28,0,24,4,4,4,4,4,6,2,2,2,0,0,0,2024-01-05 20:14:00,0
5177,5179,5179,5179,2027,24,199,24,141,2027,58,24,123,121,119,24,24,199,58,24,24,0,24,0,0,0,0,0,4,2,2,2,2,2,0,2024-01-05 20:16:00,0
5201,5201,5201,5201,2032,24,206,24,141,2032,65,24,124,119,119,24,24,206,65,24,24,0,24,0,0,0,0,0,0,2,2,2,5,5,0,2024-01-05 20:18:00,0
5180,5199,5179,5179,2023,24,208,24,145,2023,63,24,124,121,118,24,24,208,63,28,28,0,24,4,4,4,4,4,6,2,2,2,3,3,0,2024-01-05 20:20:00,0
5160,5160,5160,5160,2016,24,201,24,144,2016,57,24,123,119,118,24,24,201,57,27,27,0,24,3,3,3,3,3,2,2,2,2,4,4,0,2024-01-05 20:22:00,0
5194,5195,5195,5195,2028,24,217,24,150,2028,67,24,122,120,118,24,24,217,67,32,32,0,24,8,8,8,8,8,4,2,2,2,2,2,0,2024-01-05 20:24:00,0
5174,5173,5173,5173,2028,24,190,24,144,2028,46,24,124,120,118,24,24,190,46,27,27,0,24,3,3,3,3,3,4,2,2,2,4,4,0,2024-01-05 20:26:00,0
5159,5160,5160,5160,2023,24,189,24,145,2023,44,24,123,121,119,24,24,189,44,28,28,0,24,4,4,4,4,3,4,2,2,2,2,2,1,2024-01-05 20:28:00,0
5204,5204,5204,5204,2027,24,222,24,145,2027,77,24,125,119,118,24,24,222,77,28,28,0,24,4,4,4,4,4,2,2,2,2,6,6,0,2024-01-05 20:30:00,0
5116,5114,5114,5114,2001,22,199,22,146,2001,53,22,122,117,117,22,22,199,53,30,30,0,22,7,7,7,7,6,0,2,2,2,5,5,1,2024-01-05 20:32:00,0
5189,5189,5189,5189,2036,24,202,24,145,2036,57,24,118,118,118,24,24,202,57,28,28,0,24,4,4,4,4,4,0,2,2,2,0,0,0,2024-01-05 20:34:00,0
5168,5169,5169,5169,2023,24,192,24,145,2023,47,24,122,120,119,24,24,192,47,28,28,0,24,4,4,4,4,4,2,2,2,2,2,2,0,2024-01-05 20:36:00,0
5168,5169,5169,5169,2026,24,192,24,149,2026,43,24,124,120,118,24,24,192,43,31,31,0,24,7,7,7,7,7,4,2,2,2,4,4,0,2024-01-05 20:38:00,0
5171,5171,5171,5171,2027,24,195,24,145,2027,50,24,121,118,118,24,24,195,50,28,28,0,24,4,4,4,4,4,0,2,2,2,3,3,0,2024-01-05 20:40:00,0
5146,5145,5145,5145,2001,24,206,24,143,2001,63,24,126,120,119,24,24,206,63,27,27,0,24,3,3,3,3,3,2,2,2,2,6,6,0,2024-01-05 20:42:00,0
5190,5190,5190,5190,2029,24,205,24,145,2029,60,24,126,120,118,24,24,205,60,28,28,0,24,4,4,4,4,3,4,2,2,2,6,6,1,2024-01-05 20:44:00,0
5200,5219,5200,5200,2026,24,215,24,148,2026,67,24,129,121,119,24,24,215,67,31,31,0,24,7,7,7,7,7,4,2,2,2,8,8,0,2024-01-05 20:46:00,0
5173,5174,5174,5174,2021,24,207,24,145,2021,62,24,123,120,118,24,24,207,62,28,28,0,24,4,4,4,4,3,4,2,2,2,3,3,1,2024-01-05 20:48:00,0
5159,5159,5159,5159,2018,24,252,24,146,2018,106,24,120,120,118,24,24,252,55,29,29,0,24,5,5,4,4,4,4,2,2,2,0,0,0,2024-01-05 20:50:00,52
5183,5183,5183,5183,2015,24,227,24,147,2015,80,24,124,119,118,24,24,227,80,31,31,0,24,7,7,7,7,7,2,2,2,2,5,5,0,2024-01-05 20:52:00,0
5187,5187,5187,5187,2030,24,203,24,146,2030,57,24,121,120,118,24,24,203,57,28,28,0,24,4,4,4,4,4,4,2,2,2,1,1,0,2024-01-05 20:54:00,0
5143,5143,5143,5143,2010,24,204,24,144,2010,60,24,121,119,118,24,24,204,60,28,28,0,24,4,4,4,4,4,2,2,2,2,2,2,0,2024-01-05 20:56:00,0
5198,5196,5196,5196,2033,22,213,22,145,2033,68,22,119,118,118,22,22,213,68,28,28,0,22,4,4,4,4,3,0,2,2,2,1,1,1,2024-01-05 20:58:00,0
5169,5171,5171,5171,2026,24,199,24,149,2026,50,24,120,118,118,24,24,199,50,31,31,0,24,7,7,7,7,7,0,2,2,2,2,2,0,2024-01-05 21:00:00,0
5146,5146,5146,5146,2005,24,310,24,143,2005,167,24,121,119,118,24,24,310,167,27,27,0,24,3,3,3,3,3,2,2,2,2,2,2,0,2024-01-05 21:02:00,0
5152,5152,5152,5152,2017,24,196,24,144,2017,52,24,122,118,118,24,24,196,52,28,28,0,24,4,4,4,4,3,0,2,2,2,4,4,1,2024-01-05 21:04:00,0
5217,5216,5216,5216,2027,24,240,24,145,2027,95,24,121,118,118,24,24,240,95,28,28,0,24,4,4,4,4,4,0,2,2,2,3,3,0,2024-01-05 21:06:00,0
5172,5172,5172,5172,2023,24,203,24,148,2023,55,24,123,121,119,24,24,203,55,31,31,0,24,7,7,7,7,7,4,2,2,2,2,2,0,2024-01-05 21:08:00,0
5206,5206,5206,5206,2040,24,201,24,146,2040,55,24,123,120,119,24,24,201,55,28,28,0,24,4,4,4,4,4,2,2,2,2,3,3,0,2024-01-05 21:10:00,0
5168,5169,5169,5169,2024,24,195,24,145,2024,50,24,123,120,118,24,24,195,50,28,28,10,24,4,4,4,4,4,4,2,2,2,3,3,0,2024-01-05 21:12:00,0
5170,5169,5169,5169,2023,24,202,24,148,2023,54,24,125,121,118,24,24,202,54,31,31,0,24,7,7,7,7,6,6,2,2,2,4,4,1,2024-01-05 21:14:00,0
5185,5185,5185,5185,2027,24,206,24,145,2027,61,24,123,120,118,24,24,206,61,28,28,4,24,4,4,4,4,4,4,2,2,2,3,3,0,2024-01-05 21:16:00,0
5202,5203,5203,5203,2035,24,209,24,146,2035,63,24,123,120,120,24,24,209,63,28,28,0,24,4,4,4,4,3,0,2,2,2,3,3,1,2024-01-05 21:18:00,0
5138,5138,5138,5138,2015,24,191,24,144,2015,47,24,121,120,118,24,24,191,47,27,27,0,24,3,3,3,3,3,4,2,2,2,1,1,0,2024-01-05 21:20:00,0
5151,5150,5150,5150,2008,24,209,24,148,2008,61,24,124,120,117,24,24,209,61,32,32,0,24,8,8,8,8,8,6,2,2,2,4,4,0,2024-01-05 21:22:00,0
5196,5197,5197,5197,2032,22,208,22,145,2032,63,22,121,119,119,22,22,208,63,27,27,0,22,3,3,3,3,3,0,2,2,2,2,2,0,2024-01-05 21:24:00,0
5190,5190,5189,5189,2031,24,209,24,145,2031,64,24,120,118,118,24,24,209,64,28,28,0,24,4,4,4,4,4,0,2,2,2,2,2,0,2024-01-05 21:26:00,0
5173,5175,5174,5174,2028,24,199,24,148,2028,51,24,121,119,118,24,24,199,51,31,31,0,24,7,7,7,7,7,2,2,2,2,2,2,0,2024-01-05 21:28:00,0
5193,5193,5193,5193,2029,24,203,24,145,2029,58,24,129,120,119,24,24,203,58,28,28,0,24,4,4,4,4,3,2,2,2,2,9,9,1,2024-01-05 21:30:00,0
5164,5162,5162,5162,2023,24,195,24,145,2023,50,24,122,118,118,24,24,195,50,28,28,0,24,4,4,4,4,4,0,2,2,2,4,4,0,2024-01-05 21:32:00,0
5147,5147,5147,5147,2016,24,192,24,145,2016,47,24,121,119,118,24,24,192,47,28,28,0,24,4,4,4,4,3,2,2,2,2,2,2,1,2024-01-05 21:34:00,0
5177,5179,5179,5179,2021,24,214,24,148,2021,66,24,122,119,118,24,24,214,66,31,31,0,24,7,7,7,7,7,2,2,2,2,3,3,0,2024-01-05 21:36:00,0
5197,5197,5197,5197,2029,24,217,24,145,2029,72,24,118,118,118,24,24,217,72,28,28,0,24,4,4,4,4,4,0,2,2,2,0,0,0,2024-01-05 21:38:00,0
5177,5175,5175,5175,2029,24,199,24,144,2029,55,24,119,118,118,24,24,199,55,27,27,0,24,3,3,3,3,3,0,2,2,2,1,1,0,2024-01-05 21:40:00,0
5203,5205,5205,5205,2029,24,222,24,150,2029,72,24,125,120,119,24,24,222,72,32,32,0,24,8,8,8,8,8,2,2,2,2,5,5,0,2024-01-05 21:42:00,0
5145,5144,5144,5144,2008,24,214,24,143,2008,71,24,120,118,117,24,24,214,71,27,27,0,24,3,3,3,3,3,2,2,2,2,2,2,0,2024-01-05 21:44:00,0
5177,5197,5177,5177,2023,24,208,24,145,2023,63,24,122,119,118,24,24,208,63,28,28,2,24,4,4,4,4,3,2,2,2,2,3,3,1,2024-01-05 21:46:00,0
5166,5167,5167,5167,2017,24,208,24,147,2017,61,24,122,119,118,24,24,208,61,30,30,4,24,5,4,4,4,4,2,2,2,2,3,3,0,2024-01-05 21:48:00,3
5203,5202,5202,5202,2026,22,288,22,149,2026,139,22,122,119,119,22,22,288,88,32,32,0,22,8,8,7,7,6,0,2,2,2,3,3,1,2024-01-05 21:50:00,52
5182,5183,5183,5183,2027,24,198,24,145,2027,53,24,123,121,119,24,24,198,53,28,28,0,24,4,4,4,4,4,4,2,2,2,2,2,0,2024-01-05 21:52:00,0
5178,5176,5176,5176,2024,24,201,24,145,2024,56,24,125,123,118,24,24,201,56,28,28,0,24,4,4,4,4,4,10,2,2,2,2,2,0,2024-01-05 21:54:00,0
5188,5188,5188,5188,2022,24,217,24,144,2022,73,24,124,121,118,24,24,217,73,27,27,0,24,3,3,3,3,3,6,2,2,2,3,3,0,2024-01-05 21:56:00,0
5174,5174,5174,5174,2021,24,211,24,149,2021,62,24,123,120,118,24,24,211,62,32,32,0,24,8,8,8,8,8,4,2,2,2,3,3,0,2024-01-05 21:58:00,0
5221,5223,5223,5223,2042,24,208,24,145,2042,63,24,124,121,119,24,24,208,63,27,27,0,24,3,3,3,3,3,4,2,2,2,3,3,0,2024-01-05 22:00:00,0
5180,5180,5180,5180,2013,24,229,24,145,2013,84,24,123,122,118,24,24,229,84,28,28,5,24,4,4,4,4,3,8,2,2,2,1,1,1,2024-01-05 22:02:00,0
5195,5194,5194,5194,2022,24,221,24,148,2022,73,24,133,123,119,24,24,221,73,31,31,0,24,7,7,7,7,7,8,2,2,2,10,10,0,2024-01-05 22:04:00,0
5168,5169,5169,5169,2019,24,202,24,145,2019,57,24,122,119,118,24,24,202,57,28,28,0,24,4,4,4,4,3,2,2,2,2,3,3,1,2024-01-05 22:06:00,0
5182,5181,5181,5181,2022,24,217,24,145,2022,72,24,127,122,118,24,24,217,72,28,28,0,24,4,4,4,4,4,8,2,2,2,5,5,0,2024-01-05 22:08:00,0
5203,5204,5204,5204,2036,24,207,24,145,2036,62,24,123,119,118,24,24,207,62,28,28,0,24,4,4,4,4,4,2,2,2,2,4,4,0,2024-01-05 22:10:00,0
5160,5160,5160,5160,2019,24,198,24,148,2019,50,24,125,121,119,24,24,198,50,31,31,0,24,7,7,7,7,7,4,2,2,2,4,4,0,2024-01-05 22:12:00,0
5166,5164,5164,5164,2022,24,200,24,145,2022,55,24,122,122,118,24,24,200,55,28,28,0,24,4,4,4,4,4,8,2,2,2,0,0,0,2024-01-05 22:14:00,0
5169,5171,5171,5171,2023,22,192,22,145,2023,47,22,127,122,119,22,22,192,47,28,28,0,22,4,4,4,4,3,6,2,2,2,5,5,1,2024-01-05 22:16:00,0
5182,5182,5182,5182,2027,24,207,24,148,2027,59,24,122,120,118,24,24,207,59,31,31,0,24,7,7,7,7,7,4,2,2,2,2,2,0,2024-01-05 22:18:00,0
5204,5204,5204,5204,2028,24,220,24,144,2028,76,24,125,120,119,24,24,220,76,27,27,0,24,3,3,3,3,3,2,2,2,2,5,5,0,2024-01-05 22:20:00,0
5163,5162,5162,5162,2009,24,216,24,145,2009,71,24,125,121,118,24,24,216,71,28,28,0,24,4,4,4,4,3,6,2,2,2,4,4,1,2024-01-05 22:22:00,0
5183,5184,5184,5184,2028,24,203,24,145,2028,58,24,123,120,118,24,24,203,58,28,28,0,24,4,4,4,4,4,4,2,2,2,3,3,0,2024-01-05 22:24:00,0
5206,5224,5205,5205,2032,24,221,24,148,2032,73,24,123,121,119,24,24,221,73,31,31,0,24,7,7,7,7,7,4,2,2,2,2,2,0,2024-01-05 22:26:00,0
5200,5201,5201,5201,2036,24,206,24,146,2036,60,24,124,121,118,24,24,206,60,28,28,0,24,4,4,4,4,4,6,2,2,2,3,3,0,2024-01-05 22:28:00,0
5164,5164,5163,5163,2014,24,215,24,144,2014,71,24,128,121,118,24,24,215,71,28,28,0,24,4,4,4,4,4,6,2,2,2,7,7,0,2024-01-05 22:30:00,0
5182,5181,5181,5181,2029,24,201,24,145,2029,56,24,121,120,119,24,24,201,56,28,28,0,24,4,4,4,4,3,2,2,2,2,1,1,1,2024-01-05 22:32:00,0
5176,5179,5178,5178,2026,24,206,24,148,2026,58,24,122,120,118,24,24,206,58,31,31,0,24,7,7,7,7,7,4,2,2,2,2,2,0,2024-01-05 22:34:00,0
5188,5188,5188,5188,2027,24,203,24,145,2027,58,24,126,120,118,24,24,203,58,27,27,0,24,3,3,3,3,3,4,2,2,2,6,6,0,2024-01-05 22:36:00,0
5160,5159,5159,5159,2015,24,208,24,144,2015,64,24,121,120,118,24,24,208,64,28,28,0,24,4,4,4,4,3,4,2,2,2,1,1,1,2024-01-05 22:38:00,0
5170,5170,5170,5170,2026,24,197,24,149,2026,48,24,126,120,118,24,24,197,48,32,32,0,24,8,8,8,8,8,4,2,2,2,6,6,0,2024-01-05 22:40:00,0
5183,5184,5184,5184,2022,22,208,22,144,2022,64,22,131,120,118,22,22,208,64,27,27,0,22,3,3,3,3,3,4,2,2,2,11,11,0,2024-01-05 22:42:00,0
5185,5184,5184,5184,2031,24,201,24,146,2031,55,24,121,119,119,24,24,201,55,28,28,0,24,4,4,4,4,4,0,2,2,2,2,2,0,2024-01-05 22:44:00,0
5172,5173,5173,5173,2028,24,192,24,145,2028,47,24,123,120,119,24,24,192,47,28,28,0,24,4,4,4,4,4,2,2,2,2,3,3,0,2024-01-05 22:46:00,0
5191,5189,5189,5189,2026,24,215,24,148,2026,67,24,125,120,119,24,24,215,67,31,31,0,24,7,7,7,7,6,2,2,2,2,5,5,1,2024-01-05 22:48:00,0
5171,5173,5173,5173,2018,24,253,24,146,2018,107,24,129,122,119,24,24,253,56,29,29,0,24,5,5,4,4,4,6,2,2,2,7,7,0,2024-01-05 22:50:00,52
5200,5199,5199,5199,2039,24,202,24,148,2039,54,24,127,122,119,24,24,202,54,30,30,0,24,5,4,4,4,3,6,2,2,2,5,5,1,2024-01-05 22:52:00,3
5173,5173,5173,5173,2017,24,217,24,147,2017,70,24,121,120,118,24,24,217,70,31,31,0,24,7,7,7,7,7,4,2,2,2,1,1,0,2024-01-05 22:54:00,0
5137,5139,5138,5138,2004,24,212,24,144,2004,68,24,121,119,117,24,24,212,68,28,28,0,24,4,4,4,4,4,4,2,2,2,2,2,0,2024-01-05 22:56:00,0
5162,5162,5162,5162,2021,24,193,24,144,2021,49,24,125,120,118,24,24,193,49,27,27,0,24,3,3,3,3,3,4,2,2,2,5,5,0,2024-01-05 22:58:00,0
5186,5185,5185,5185,2028,24,206,24,145,2028,61,24,121,120,119,24,24,206,61,28,28,0,24,4,4,4,4,4,2,2,2,2,1,1,0,2024-01-05 23:00:00,0
5153,5154,5154,5154,2009,24,211,24,148,2009,63,24,123,120,118,24,24,211,63,31,31,0,24,7,7,7,7,7,4,2,2,2,3,3,0,2024-01-05 23:02:00,0
5181,5181,5181,5181,2017,24,225,24,145,2017,80,24,123,120,118,24,24,225,80,28,28,0,24,4,4,4,4,3,4,2,2,2,3,3,1,2024-01-05 23:04:00,0
5185,5184,5184,5184,2022,24,212,24,145,2022,67,24,124,118,118,24,24,212,67,28,28,0,24,4,4,4,4,4,0,2,2,2,6,6,0,2024-01-05 23:06:00,0
5160,5160,5160,5160,2025,22,192,22,145,2025,47,22,122,118,118,22,22,192,47,28,28,0,22,4,4,4,4,3,0,2,2,2,4,4,1,2024-01-05 23:08:00,0
5149,5149,5149,5149,2013,24,198,24,147,2013,51,24,121,120,118,24,24,198,51,31,31,0,24,7,7,7,7,7,4,2,2,2,1,1,0,2024-01-05 23:10:00,0
5182,5183,5183,5183,2019,24,219,24,145,2019,74,24,123,122,118,24,24,219,74,28,28,0,24,4,4,4,4,4,8,2,2,2,1,1,0,2024-01-05 23:12:00,0
5193,5193,5193,5193,2033,24,202,24,144,2033,58,24,124,119,118,24,24,202,58,27,27,0,24,3,3,3,3,3,2,2,2,2,5,5,0,2024-01-05 23:14:00,0
5153,5152,5152,5152,2017,24,195,24,149,2017,46,24,123,118,118,24,24,195,46,32,32,0,24,8,8,8,8,8,0,2,2,2,5,5,0,2024-01-05 23:16:00,0
5131,5132,5132,5132,2003,24,200,24,142,2003,58,24,125,121,118,24,24,200,58,26,26,0,24,3,3,3,3,3,6,2,2,2,4,4,0,2024-01-05 23:18:00,0
5169,5188,5169,5169,2025,24,198,24,145,2025,53,24,123,120,118,24,24,198,53,28,28,0,24,4,4,4,4,3,4,2,2,2,3,3,1,2024-01-05 23:20:00,0
5187,5187,5187,5187,2022,24,216,24,145,2022,71,24,124,120,119,24,24,216,71,28,28,0,24,4,4,4,4,4,2,2,2,2,4,4,0,2024-01-05 23:22:00,0
5194,5193,5193,5193,2027,24,218,24,148,2027,70,24,122,118,118,24,24,218,70,31,31,0,24,7,7,7,7,6,0,2,2,2,4,4,1,2024-01-05 23:24:00,0
5207,5208,5208,5208,2038,24,207,24,146,2038,61,24,124,120,119,24,24,207,61,28,28,0,24,4,4,4,4,4,2,2,2,2,4,4,0,2024-01-05 23:26:00,0
5200,5200,5200,5200,2032,24,211,24,146,2032,65,24,123,120,118,24,24,211,65,28,28,0,24,4,4,4,4,4,4,2,2,2,3,3,0,2024-01-05 23:28:00,0
5174,5172,5172,5172,2029,24,199,24,148,2029,51,24,121,118,118,24,24,199,51,31,31,0,24,7,7,7,7,7,0,2,2,2,3,3,0,2024-01-05 23:30:00,0
5203,5203,5203,5203,2031,24,216,24,145,2031,71,24,124,122,120,24,24,216,71,28,28,0,24,4,4,4,4,4,4,2,2,2,2,2,0,2024-01-05 23:32:00,0
5179,5180,5180,5180,2026,22,200,22,144,2026,56,22,124,121,119,22,22,200,56,27,27,0,22,3,3,3,3,3,4,2,2,2,3,3,0,2024-01-05 23:34:00,0
5176,5195,5176,5176,2024,24,204,24,145,2024,59,24,121,118,118,24,24,204,59,28,28,0,24,4,4,4,4,3,0,2,2,2,3,3,1,2024-01-05 23:36:00,0
5173,5174,5174,5174,2027,24,200,24,149,2027,51,24,121,119,118,24,24,200,51,32,32,0,24,7,7,7,7,7,2,2,2,2,2,2,0,2024-01-05 23:38:00,0
5183,5182,5182,5182,2033,24,189,24,146,2033,43,24,124,120,120,24,24,189,43,28,28,0,24,4,4,4,4,3,0,2,2,2,4,4,1,2024-01-05 23:40:00,0
5106,5107,5107,5107,1993,24,200,24,143,1993,57,24,120,117,117,24,24,200,57,27,27,0,24,4,4,4,4,4,0,2,2,2,3,3,0,2024-01-05 23:42:00,0
5187,5185,5185,5185,2020,24,219,24,144,2020,75,24,122,120,118,24,24,219,75,28,28,0,24,4,4,4,4,4,4,2,2,2,2,2,0,2024-01-05 23:44:00,0
5184,5185,5185,5185,2017,24,219,24,148,2017,71,24,129,123,119,24,24,219,71,31,31,0,24,7,7,7,7,7,8,2,2,2,6,6,0,2024-01-05 23:46:00,0
5182,5182,5182,5182,2033,24,196,24,146,2033,50,24,118,118,118,24,24,196,50,28,28,0,24,4,4,4,4,4,0,2,2,2,0,0,0,2024-01-05 23:48:00,0
5179,5180,5180,5180,2024,24,254,24,146,2024,108,24,125,120,119,24,24,254,57,29,29,0,24,5,5,4,4,3,2,2,2,2,5,5,1,2024-01-05 23:50:00,52
5189,5187,5187,5187,2025,24,218,24,148,2025,70,24,123,119,119,24,24,218,70,31,31,0,24,7,7,7,7,7,0,2,2,2,4,4,0,2024-01-05 23:52:00,0
5165,5167,5167,5167,2023,24,196,24,144,2023,52,24,124,120,118,24,24,196,52,27,27,0,24,3,3,3,3,3,4,2,2,2,4,4,0,2024-01-05 23:54:00,0
5209,5209,5208,5208,2037,24,212,24,145,2037,67,24,122,118,118,24,24,212,67,28,28,0,24,4,4,4,4,3,0,2,2,2,4,4,1,2024-01-05 23:56:00,0
5182,5202,5183,5183,2021,24,212,24,145,2021,67,24,125,123,120,24,24,212,67,28,28,0,24,4,4,4,4,4,6,2,2,2,2,2,0,2024-01-05 23:58:00,0
5160,5160,5160,5160,2016,22,209,22,147,2016,62,22,121,119,118,22,22,209,62,31,31,0,22,7,7,7,7,7,2,2,2,2,2,2,0,2024-01-06 00:00:00,0
5178,5178,5178,5178,2016,24,214,24,146,2016,68,24,123,118,118,24,24,214,68,28,28,0,24,4,4,4,4,4,0,2,2,2,5,5,0,2024-01-06 00:02:00,0
5164,5164,5164,5164,2021,24,198,24,144,2021,54,24,123,121,118,24,24,198,54,28,28,0,24,4,4,4,4,4,6,2,2,2,2,2,0,2024-01-06 00:04:00,0
5159,5158,5158,5158,2021,24,209,24,148,2021,61,24,122,119,118,24,24,209,61,31,31,0,24,7,7,7,7,6,2,2,2,2,3,3,1,2024-01-06 00:06:00,0
5206,5206,5206,5206,2023,24,233,24,145,2023,88,24,127,121,119,24,24,233,88,28,28,0,24,4,4,4,4,4,4,2,2,2,6,6,0,2024-01-06 00:08:00,0
5163,5164,5164,5164,2016,24,203,24,143,2016,60,24,126,119,118,24,24,203,60,27,27,0,24,3,3,3,3,3,2,2,2,2,7,7,0,2024-01-06 00:10:00,0
5162,5161,5161,5161,2019,24,205,24,145,2019,60,24,122,119,118,24,24,205,60,28,28,0,24,4,4,4,4,3,2,2,2,2,3,3,1,2024-01-06 00:12:00,0
5157,5158,5158,5158,2025,24,202,24,149,2025,53,24,121,120,119,24,24,202,53,32,32,0,24,8,8,8,8,8,2,2,2,2,1,1,0,2024-01-06 00:14:00,0
5178,5178,5178,5178,2030,24,199,24,144,2030,55,24,122,121,119,24,24,199,55,27,27,0,24,3,3,3,3,3,4,2,2,2,1,1,0,2024-01-06 00:16:00,0
5208,5227,5208,5208,2038,24,206,24,146,2038,60,24,124,120,119,24,24,206,60,28,28,0,24,4,4,4,4,4,2,2,2,2,4,4,0,2024-01-06 00:18:00,0
5172,5191,5172,5172,2021,24,206,24,145,2021,61,24,125,120,118,24,24,206,61,28,28,4,24,4,4,4,4,4,4,2,2,2,5,5,0,2024-01-06 00:20:00,0
5167,5166,5166,5166,2011,24,218,24,147,2011,71,24,127,126,119,24,24,218,71,31,31,5,24,7,7,7,7,6,14,2,2,2,1,1,1,2024-01-06 00:22:00,0
5178,5179,5179,5179,2019,24,210,24,145,2019,65,24,129,121,118,24,24,210,65,28,28,0,24,4,4,4,4,4,6,2,2,2,8,8,0,2024-01-06 00:24:00,0
5184,5183,5183,5183,2036,22,196,22,146,2036,50,22,121,119,118,22,22,196,50,28,28,0,22,4,4,4,4,3,2,2,2,2,2,2,1,2024-01-06 00:26:00,0
5120,5120,5120,5120,1997,24,213,24,146,1997,67,24,120,118,117,24,24,213,67,31,31,0,24,7,7,7,7,7,2,2,2,2,2,2,0,2024-01-06 00:28:00,0
5178,5178,5178,5178,2016,24,216,24,145,2016,71,24,127,120,119,24,24,216,71,28,28,0,24,4,4,4,4,4,2,2,2,2,7,7,0,2024-01-06 00:30:00,0
5178,5179,5179,5179,2028,24,202,24,144,2028,58,24,122,119,118,24,24,202,58,27,27,0,24,3,3,3,3,3,2,2,2,2,3,3,0,2024-01-06 00:32:00,0
5204,5202,5202,5202,2034,24,212,24,146,2034,66,24,123,119,119,24,24,212,66,28,28,0,24,4,4,4,4,4,0,2,2,2,4,4,0,2024-01-06 00:34:00,0
5183,5184,5184,5184,2028,24,202,24,148,2028,54,24,126,120,118,24,24,202,54,31,31,0,24,7,7,7,7,7,4,2,2,2,6,6,0,2024-01-06 00:36:00,0
5167,5168,5168,5168,2023,24,198,24,145,2023,53,24,121,119,118,24,24,198,53,28,28,0,24,4,4,4,4,3,2,2,2,2,2,2,1,2024-01-06 00:38:00,0
5163,5162,5162,5162,2027,24,189,24,145,2027,44,24,119,118,118,24,24,189,44,28,28,5,24,4,4,4,4,4,0,2,2,2,1,1,0,2024-01-06 00:40:00,0
5133,5134,5134,5134,2014,24,189,24,148,2014,41,24,122,120,118,24,24,189,41,31,31,0,24,7,7,7,7,6,4,2,2,2,2,2,1,2024-01-06 00:42:00,0
5195,5194,5194,5194,2030,24,204,24,145,2030,59,24,127,120,119,24,24,204,59,28,28,0,24,4,4,4,4,4,2,2,2,2,7,7,0,2024-01-06 00:44:00,0
5207,5208,5208,5208,2039,24,207,24,146,2039,61,24,124,120,118,24,24,207,61,28,28,0,24,4,4,4,4,4,4,2,2,2,4,4,0,2024-01-06 00:46:00,0
5205,5205,5205,5205,2034,24,215,24,145,2034,70,24,121,120,119,24,24,215,70,27,27,0,24,3,3,3,3,3,2,2,2,2,1,1,0,2024-01-06 00:48:00,0
5196,5196,5196,5196,2030,24,269,24,150,2030,119,24,126,119,118,24,24,269,68,33,33,0,24,9,9,8,8,8,2,2,2,2,7,7,0,2024-01-06 00:50:00,52
5118,5118,5118,5118,2007,22,189,22,143,2007,46,22,121,118,117,22,22,189,46,27,27,0,22,3,3,3,3,3,2,2,2,2,3,3,0,2024-01-06 00:52:00,0
5181,5181,5181,5181,2028,24,203,24,145,2028,58,24,124,122,118,24,24,203,58,28,28,0,24,4,4,4,4,3,8,2,2,2,2,2,1,2024-01-06 00:54:00,0
5178,5178,5178,5178,2025,24,205,24,145,2025,60,24,122,121,119,24,24,205,60,28,28,0,24,4,4,4,4,4,4,2,2,2,1,1,0,2024-01-06 00:56:00,0
5170,5189,5169,5169,2023,24,206,24,148,2023,58,24,121,120,119,24,24,206,58,31,31,0,24,7,7,7,7,6,2,2,2,2,1,1,1,2024-01-06 00:58:00,0
5177,5178,5178,5178,2030,24,199,24,146,2030,53,24,122,121,118,24,24,199,53,28,28,0,24,4,4,4,4,4,6,2,2,2,1,1,0,2024-01-06 01:00:00,0
5198,5198,5198,5198,2021,24,324,24,145,2021,179,24,130,125,119,24,24,324,179,28,28,1,24,4,4,4,4,4,12,2,2,2,5,5,0,2024-01-06 01:02:00,0
5179,5178,5178,5178,2020,24,223,24,148,2020,75,24,120,119,117,24,24,223,75,31,31,9,24,7,7,7,7,7,4,2,2,2,1,1,0,2024-01-06 01:04:00,0
5165,5165,5165,5165,2012,24,216,24,144,2012,72,24,124,122,118,24,24,216,72,28,28,4,24,4,4,4,4,4,8,2,2,2,2,2,0,2024-01-06 01:06:00,0
5203,5204,5204,5204,2026,24,233,24,146,2026,87,24,125,122,119,24,24,233,87,29,29,2,24,4,3,3,3,3,6,2,2,2,3,3,0,2024-01-06 01:08:00,3
5209,5209,5209,5209,2035,24,217,24,146,2035,71,24,125,122,118,24,24,217,71,28,28,4,24,4,4,4,4,3,8,2,2,2,3,3,1,2024-01-06 01:10:00,0
5147,5165,5146,5146,2001,24,227,24,147,2001,80,24,124,122,118,24,24,227,80,31,31,0,24,7,7,7,7,7,8,2,2,2,2,2,0,2024-01-06 01:12:00,0
5196,5197,5197,5197,2027,24,218,24,145,2027,73,24,123,119,118,24,24,218,73,28,28,0,24,4,4,4,4,3,2,2,2,2,4,4,1,2024-01-06 01:14:00,0
5171,5170,5170,5170,2022,23,204,23,145,2022,59,23,123,119,118,23,23,204,59,28,28,0,23,4,4,4,4,4,2,2,2,2,4,4,0,2024-01-06 01:16:00,0
5173,5173,5173,5173,2024,23,206,23,145,2024,61,23,120,119,119,23,23,206,61,28,28,0,23,4,4,4,4,4,0,2,2,2,1,1,0,2024-01-06 01:18:00,0
5208,5208,5208,5208,2032,24,220,24,149,2032,71,24,129,122,118,24,24,220,71,31,31,0,24,7,7,7,7,7,8,2,2,2,7,7,0,2024-01-06 01:20:00,0
5141,5142,5142,5142,2008,24,211,24,144,2008,67,24,121,119,118,24,24,211,67,28,28,0,24,4,4,4,4,4,2,2,2,2,2,2,0,2024-01-06 01:22:00,0
5211,5230,5211,5211,2035,24,221,24,149,2035,72,24,123,118,118,24,24,221,72,31,31,0,24,4,4,4,4,3,0,2,2,2,5,5,1,2024-01-06 01:24:00,6
5180,5199,5180,5180,2024,24,211,24,148,2024,63,24,125,121,118,24,24,211,63,31,31,0,24,7,7,7,7,7,6,2,2,2,4,4,0,2024-01-06 01:26:00,0
5205,5205,5205,5205,2035,24,209,24,144,2035,65,24,125,120,119,24,24,209,65,27,27,0,24,3,3,3,3,3,2,2,2,2,5,5,0,2024-01-06 01:28:00,0
5200,5200,5200,5200,2028,24,214,24,145,2028,69,24,127,122,119,24,24,214,69,28,28,0,24,4,4,4,4,3,6,2,2,2,5,5,1,2024-01-06 01:30:00,0
5208,5208,5208,5208,2030,24,222,24,146,2030,76,24,127,122,119,24,24,222,76,28,28,0,24,4,4,4,4,4,6,2,2,2,5,5,0,2024-01-06 01:32:00,0
5194,5194,5194,5194,2022,24,230,24,147,2022,83,24,122,118,118,24,24,230,83,31,31,0,24,7,7,7,7,7,0,2,2,2,4,4,0,2024-01-06 01:34:00,0
5158,5176,5157,5157,2009,24,230,24,144,2009,86,24,122,119,117,24,24,230,86,28,28,0,24,4,4,4,4,4,4,2,2,2,3,3,0,2024-01-06 01:36:00,0
5197,5197,5197,5197,2035,24,204,24,146,2035,58,24,128,121,119,24,24,204,58,28,28,0,24,4,4,4,4,4,4,2,2,2,7,7,0,2024-01-06 01:38:00,0
5176,5177,5177,5177,2023,24,206,24,145,2023,61,24,124,121,119,24,24,206,61,28,28,0,24,4,4,4,4,3,4,2,2,2,3,3,1,2024-01-06 01:40:00,0
5155,5155,5154,5154,2011,24,210,24,148,2011,62,24,123,120,117,24,24,210,62,31,31,0,24,7,7,7,7,7,6,2,2,2,3,3,0,2024-01-06 01:42:00,0
5195,5196,5196,5196,2032,22,214,22,144,2032,70,22,122,119,119,22,22,214,70,27,27,0,22,3,3,3,3,3,0,2,2,2,3,3,0,2024-01-06 01:44:00,0
5166,5166,5166,5166,2014,24,213,24,145,2014,68,24,125,121,119,24,24,213,68,28,28,0,24,4,4,4,4,3,4,2,2,2,4,4,1,2024-01-06 01:46:00,0
5182,5182,5182,5182,2028,24,210,24,149,2028,61,24,122,119,118,24,24,210,61,32,32,0,24,8,8,8,8,8,2,2,2,2,3,3,0,2024-01-06 01:48:00,0
5191,5191,5191,5191,2017,24,281,24,144,2017,137,24,127,121,119,24,24,281,86,28,28,0,24,4,4,3,3,3,4,2,2,2,6,6,0,2024-01-06 01:50:00,52
5181,5181,5181,5181,2024,24,206,24,145,2024,61,24,126,121,118,24,24,206,61,28,28,0,24,4,4,4,4,4,6,2,2,2,5,5,0,2024-01-06 01:52:00,0
5182,5182,5182,5182,2027,24,207,24,145,2027,62,24,121,120,118,24,24,207,62,28,28,0,24,4,4,4,4,4,4,2,2,2,1,1,0,2024-01-06 01:54:00,0
5173,5193,5173,5173,2017,24,217,24,148,2017,69,24,123,119,119,24,24,217,69,31,31,0,24,7,7,7,7,6,0,2,2,2,4,4,1,2024-01-06 01:56:00,0
5192,5192,5192,5192,2026,24,215,24,145,2026,70,24,123,120,118,24,24,215,70,28,28,0,24,4,4,4,4,4,4,2,2,2,3,3,0,2024-01-06 01:58:00,0
5143,5143,5143,5143,2007,24,212,24,143,2007,69,24,123,118,117,24,24,212,69,27,27,0,24,4,4,4,4,3,2,2,2,2,5,5,1,2024-01-06 02:00:00,0
5189,5189,5189,5189,2017,24,229,24,148,2017,81,24,127,123,119,24,24,229,81,31,31,5,24,7,7,7,7,7,8,2,2,2,4,4,0,2024-01-06 02:02:00,0
5182,5182,5182,5182,2026,24,208,24,146,2026,62,24,125,120,118,24,24,208,62,29,29,0,24,4,4,4,4,4,4,2,2,2,5,5,0,2024-01-06 02:04:00,0
5213,5212,5212,5212,2032,24,223,24,145,2032,78,24,124,121,119,24,24,223,78,27,27,0,24,3,3,3,3,3,4,2,2,2,3,3,0,2024-01-06 02:06:00,0
5165,5166,5166,5166,2016,24,207,24,144,2016,63,24,123,120,118,24,24,207,63,28,28,0,24,4,4,4,4,4,4,2,2,2,3,3,0,2024-01-06 02:08:00,0
5190,5190,5190,5190,2029,22,216,22,149,2029,67,22,119,118,118,22,22,216,67,31,31,0,22,7,7,7,7,7,0,2,2,2,1,1,0,2024-01-06 02:10:00,0
5215,5215,5215,5215,2036,24,215,24,146,2036,69,24,126,123,121,24,24,215,69,29,29,0,24,4,4,4,4,3,4,2,2,2,3,3,1,2024-01-06 02:12:00,2
5187,5187,5187,5187,2028,24,204,24,146,2028,58,24,125,119,118,24,24,204,58,28,28,0,24,4,4,4,4,4,2,2,2,2,6,6,0,2024-01-06 02:14:00,0
5183,5182,5182,5182,2023,24,212,24,144,2023,68,24,122,120,118,24,24,212,68,28,28,0,24,4,4,4,4,3,4,2,2,2,2,2,1,2024-01-06 02:16:00,0
5160,5161,5161,5161,2025,24,191,24,149,2025,42,24,125,122,119,24,24,191,42,31,31,0,24,7,7,7,7,7,6,2,2,2,3,3,0,2024-01-06 02:18:00,0
5182,5182,5182,5182,2031,24,195,24,145,2031,50,24,121,118,118,24,24,195,50,28,28,0,24,4,4,4,4,4,0,2,2,2,3,3,0,2024-01-06 02:20:00,0
5154,5154,5154,5154,2010,24,218,24,144,2010,74,24,119,118,117,24,24,218,74,27,27,0,24,3,3,3,3,3,2,2,2,2,1,1,0,2024-01-06 02:22:00,2
5176,5176,5176,5176,2019,24,222,24,150,2019,72,24,120,118,118,24,24,222,72,34,34,0,24,8,8,8,8,8,0,2,2,2,2,2,0,2024-01-06 02:24:00,4
5167,5166,5166,5166,2023,24,194,24,144,2023,50,24,124,121,118,24,24,194,50,27,27,0,24,3,3,3,3,3,6,2,2,2,3,3,0,2024-01-06 02:26:00,0
5172,5173,5173,5173,2026,24,196,24,145,2026,51,24,124,121,119,24,24,196,51,28,28,0,24,4,4,4,4,3,4,2,2,2,3,3,1,2024-01-06 02:28:00,0
5200,5199,5199,5199,2035,24,204,24,146,2035,58,24,126,122,118,24,24,204,58,28,28,0,24,4,4,4,4,4,8,2,2,2,4,4,0,2024-01-06 02:30:00,0
5161,5162,5162,5162,2012,24,210,24,147,2012,63,24,126,123,118,24,24,210,63,31,31,0,24,7,7,7,7,6,10,2,2,2,3,3,1,2024-01-06 02:32:00,0
5178,5177,5177,5177,2024,24,204,24,145,2024,59,24,124,120,119,24,24,204,59,28,28,0,24,4,4,4,4,4,2,2,2,2,4,4,0,2024-01-06 02:34:00,0
5177,5177,5177,5177,2018,22,218,22,145,2018,73,22,120,119,118,22,22,218,73,28,28,0,22,4,4,4,4,4,2,2,2,2,1,1,0,2024-01-06 02:36:00,0
5171,5171,5171,5171,2022,24,207,24,148,2022,59,24,122,119,118,24,24,207,59,31,31,0,24,7,7,7,7,7,2,2,2,2,3,3,0,2024-01-06 02:38:00,0
5158,5159,5159,5159,2015,24,201,24,144,2015,57,24,125,121,119,24,24,201,57,28,28,0,24,4,4,4,4,4,4,2,2,2,4,4,0,2024-01-06 02:40:00,0
5150,5150,5150,5150,2017,24,195,24,144,2017,51,24,119,118,118,24,24,195,51,27,27,0,24,3,3,3,3,3,0,2,2,2,1,1,0,2024-01-06 02:42:00,0
5143,5142,5142,5142,2011,24,189,24,144,2011,45,24,124,118,118,24,24,189,45,28,28,0,24,4,4,4,4,3,0,2,2,2,6,6,1,2024-01-06 02:44:00,0
5093,5093,5093,5093,1994,24,192,24,146,1994,46,24,120,116,116,24,24,192,46,31,31,0,24,7,7,7,7,7,0,2,2,2,4,4,0,2024-01-06 02:46:00,0
5190,5191,5190,5190,2028,24,209,24,145,2028,64,24,124,120,119,24,24,209,64,28,28,0,24,4,4,4,4,3,2,2,2,2,4,4,1,2024-01-06 02:48:00,0
5185,5186,5186,5186,2030,24,254,24,147,2030,107,24,120,118,118,24,24,254,56,29,29,0,24,5,5,4,4,4,0,2,2,2,2,2,0,2024-01-06 02:50:00,52
5182,5182,5182,5182,2025,24,214,24,148,2025,66,24,122,120,118,24,24,214,66,31,31,0,24,7,7,7,7,7,4,2,2,2,2,2,0,2024-01-06 02:52:00,0
5188,5186,5186,5186,2029,24,204,24,145,2029,59,24,123,119,118,24,24,204,59,28,28,0,24,4,4,4,4,4,2,2,2,2,4,4,0,2024-01-06 02:54:00,0
5176,5177,5177,5177,2033,24,191,24,146,2033,45,24,120,120,119,24,24,191,45,28,28,0,24,4,4,4,4,4,2,2,2,2,0,0,0,2024-01-06 02:56:00,0
5189,5190,5190,5190,2028,24,210,24,145,2028,65,24,121,119,118,24,24,210,65,28,28,0,24,4,4,4,4,3,2,2,2,2,2,2,1,2024-01-06 02:58:00,0
5210,5209,5209,5209,2032,24,225,24,148,2032,77,24,121,119,118,24,24,225,77,31,31,0,24,7,7,7,7,7,2,2,2,2,2,2,0,2024-01-06 03:00:00,0
5162,5163,5163,5163,2003,22,328,22,144,2003,184,22,127,123,119,22,22,328,184,27,27,0,22,3,3,3,3,3,8,2,2,2,4,4,0,2024-01-06 03:02:00,0
5171,5170,5170,5170,2025,24,200,24,145,2025,55,24,120,118,118,24,24,200,55,28,28,0,24,4,4,4,4,3,0,2,2,2,2,2,1,2024-01-06 03:04:00,0
5208,5229,5209,5209,2034,24,216,24,145,2034,71,24,125,120,119,24,24,216,71,28,28,0,24,4,4,4,4,4,2,2,2,2,5,5,0,2024-01-06 03:06:00,0
5169,5169,5169,5169,2019,24,225,24,148,2019,77,24,118,117,117,24,24,225,77,31,31,0,24,7,7,7,7,7,0,2,2,2,1,1,0,2024-01-06 03:08:00,0
5179,5179,5179,5179,2026,24,205,24,145,2026,60,24,120,119,119,24,24,205,60,28,28,0,24,4,4,4,4,4,0,2,2,2,1,1,0,2024-01-06 03:10:00,0
5180,5180,5180,5180,2031,24,207,24,161,2031,46,24,124,121,118,24,24,207,46,44,44,0,24,12,4,4,4,4,6,2,2,2,3,3,0,2024-01-06 03:12:00,69
5201,5201,5201,5201,2031,24,219,24,149,2031,70,24,124,120,119,24,24,219,70,31,31,0,24,7,7,7,7,6,2,2,2,2,4,4,1,2024-01-06 03:14:00,0
5222,5222,5222,5222,2032,24,228,24,145,2032,83,24,127,119,119,24,24,228,83,28,28,0,24,4,4,4,4,4,0,2,2,2,8,8,0,2024-01-06 03:16:00,0
5204,5223,5203,5203,2037,24,205,24,145,2037,60,24,123,119,118,24,24,205,60,27,27,0,24,3,3,3,3,3,2,2,2,2,4,4,0,2024-01-06 03:18:00,0
5191,5192,5192,5192,2028,24,211,24,145,2028,66,24,124,120,119,24,24,211,66,28,28,0,24,4,4,4,4,3,2,2,2,2,4,4,1,2024-01-06 03:20:00,0
5181,5199,5180,5180,2024,24,213,24,149,2024,64,24,123,119,119,24,24,213,64,32,32,0,24,8,8,8,8,8,0,2,2,2,4,4,0,2024-01-06 03:22:00,0
5189,5190,5190,5190,2023,24,212,24,144,2023,68,24,128,122,118,24,24,212,68,27,27,0,24,3,3,3,3,3,8,2,2,2,6,6,0,2024-01-06 03:24:00,0
5194,5193,5193,5193,2024,24,217,24,145,2024,72,24,128,122,118,24,24,217,72,28,28,0,24,4,4,4,4,4,8,2,2,2,6,6,0,2024-01-06 03:26:00,0
5203,5201,5201,5201,2031,24,219,23,148,2031,71,23,125,120,118,23,23,219,71,31,31,0,23,7,7,7,7,7,4,2,2,2,5,5,0,2024-01-06 03:28:00,0
5147,5168,5149,5149,2016,22,197,23,145,2016,52,23,125,124,118,23,23,197,52,28,28,0,23,4,4,4,4,3,12,2,2,2,1,1,1,2024-01-06 03:30:00,0
7514,7513,7513,7513,2937,34,303,34,211,2937,92,34,180,175,171,34,34,303,92,41,41,0,34,7,7,7,7,7,8,3,3,3,5,5,0,2024-01-06 03:32:00,0
5166,5184,5165,5165,2021,24,197,24,145,2021,52,24,123,121,118,24,24,197,52,28,28,0,24,4,4,4,4,3,6,2,2,2,2,2,1,2024-01-06 03:34:00,0
5176,5177,5177,5177,2027,24,201,24,149,2027,52,24,126,121,118,24,24,201,52,32,32,0,24,7,7,7,7,7,6,2,2,2,5,5,0,2024-01-06 03:36:00,2
5184,5185,5185,5185,2026,24,206,24,145,2026,61,24,122,118,118,24,24,206,61,28,28,0,24,4,4,4,4,4,0,2,2,2,4,4,0,2024-01-06 03:38:00,0
5175,5175,5175,5175,2025,24,202,24,144,2025,58,24,122,119,119,24,24,202,58,27,27,0,24,3,3,3,3,3,0,2,2,2,3,3,0,2024-01-06 03:40:00,0
5156,5156,5156,5156,2020,24,189,24,145,2020,44,24,121,119,118,24,24,189,44,28,28,0,24,4,4,4,4,4,2,2,2,2,2,2,0,2024-01-06 03:42:00,0
5176,5175,5175,5175,2028,24,198,24,148,2028,50,24,121,120,118,24,24,198,50,31,31,0,24,7,7,7,7,7,4,2,2,2,1,1,0,2024-01-06 03:44:00,0
5158,5156,5156,5156,2018,24,198,24,145,2018,53,24,122,118,118,24,24,198,53,28,28,0,24,4,4,4,4,3,0,2,2,2,4,4,1,2024-01-06 03:46:00,0
5179,5182,5182,5182,2023,24,212,24,145,2023,67,24,124,120,118,24,24,212,67,28,28,0,24,4,4,4,4,4,4,2,2,2,4,4,0,2024-01-06 03:48:00,0
5206,5226,5205,5205,2026,24,279,24,149,2026,130,24,130,121,119,24,24,279,79,32,32,0,24,8,8,7,7,6,4,2,2,2,9,9,1,2024-01-06 03:50:00,52
5158,5158,5158,5158,2015,23,210,23,144,2015,66,23,124,122,119,23,22,210,66,28,28,0,23,4,4,4,4,4,6,2,2,2,2,2,0,2024-01-06 03:52:00,0
5178,5179,5179,5179,2027,23,199,23,145,2027,54,23,127,121,118,23,24,199,54,28,28,0,23,4,4,4,4,4,6,2,2,2,6,6,0,2024-01-06 03:54:00,0
5201,5201,5201,5201,2033,24,208,24,145,2033,63,24,122,119,118,24,24,208,63,27,27,0,24,3,3,3,3,3,2,2,2,2,3,3,0,2024-01-06 03:56:00,0
5184,5184,5184,5184,2022,24,218,24,149,2022,69,24,121,120,120,24,24,218,69,32,32,0,24,8,8,8,8,8,0,2,2,2,1,1,0,2024-01-06 03:58:00,0
5166,5166,5166,5166,2013,24,209,24,143,2013,66,24,124,120,117,24,24,209,66,27,27,0,24,3,3,3,3,3,6,2,2,2,4,4,0,2024-01-06 04:00:00,0
5156,5154,5154,5154,2009,24,199,24,145,2009,54,24,130,123,118,24,24,199,54,28,28,0,24,4,4,4,4,3,10,2,2,2,7,7,1,2024-01-06 04:02:00,0
5172,5173,5173,5173,2014,24,218,24,144,2014,74,24,125,121,118,24,24,218,74,28,28,0,24,4,4,4,4,4,6,2,2,2,4,4,0,2024-01-06 04:04:00,0
5188,5188,5188,5188,2019,24,226,24,148,2019,78,24,121,119,119,24,24,226,78,31,31,0,24,7,7,7,7,6,0,2,2,2,2,2,1,2024-01-06 04:06:00,0
5181,5182,5182,5182,2022,24,210,24,145,2022,65,24,123,119,118,24,24,210,65,28,28,0,24,4,4,4,4,4,2,2,2,2,4,4,0,2024-01-06 04:08:00,0
5180,5180,5180,5180,2022,24,208,24,145,2022,63,24,124,121,118,24,24,208,63,28,28,0,24,4,4,4,4,4,6,2,2,2,3,3,0,2024-01-06 04:10:00,0
5213,5212,5212,5212,2034,24,223,24,148,2034,75,24,127,119,119,24,24,223,75,31,31,0,24,7,7,7,7,7,0,2,2,2,8,8,0,2024-01-06 04:12:00,0
5138,5139,5139,5139,1999,24,222,24,144,1999,78,24,124,119,117,24,24,222,78,28,28,0,24,4,4,4,4,4,4,2,2,2,5,5,0,2024-01-06 04:14:00,0
5195,5193,5193,5193,2031,24,204,24,144,2031,60,24,125,119,118,24,24,204,60,27,27,0,24,3,3,3,3,3,2,2,2,2,6,6,0,2024-01-06 04:16:00,0
5179,5180,5180,5180,2024,22,208,22,145,2024,63,22,122,119,118,22,22,208,63,28,28,0,22,4,4,4,4,3,2,2,2,2,3,3,1,2024-01-06 04:18:00,0
5181,5182,5182,5182,2028,24,201,24,149,2028,52,24,123,120,119,24,24,201,52,31,31,0,24,7,7,7,7,7,2,2,2,2,3,3,0,2024-01-06 04:20:00,0
5161,5161,5161,5161,2011,24,212,24,144,2011,68,24,123,121,118,24,24,212,68,28,28,0,24,4,4,4,4,3,6,2,2,2,2,2,1,2024-01-06 04:22:00,0
5203,5202,5202,5202,2038,24,206,24,147,2038,59,24,122,120,119,24,24,206,59,29,29,0,24,4,4,4,4,4,2,2,2,2,2,2,0,2024-01-06 04:24:00,2
5189,5189,5189,5189,2026,24,212,24,148,2026,64,24,126,122,118,24,24,212,64,31,31,0,24,7,7,7,7,7,8,2,2,2,4,4,0,2024-01-06 04:26:00,0
5180,5181,5181,5181,2025,24,208,24,145,2025,63,24,122,120,119,24,24,208,63,28,28,0,24,4,4,4,4,4,2,2,2,2,2,2,0,2024-01-06 04:28:00,0
5180,5200,5180,5180,2029,24,199,24,146,2029,53,24,123,120,119,24,24,199,53,28,28,0,24,4,4,4,4,4,2,2,2,2,3,3,0,2024-01-06 04:30:00,0
5172,5171,5171,5171,2015,24,212,24,144,2015,68,24,125,122,118,24,24,212,68,28,28,0,24,4,4,4,4,3,8,2,2,2,3,3,1,2024-01-06 04:32:00,0
5160,5161,5161,5161,2017,24,203,24,148,2017,55,24,126,119,117,24,24,203,55,31,31,0,24,7,7,7,7,7,4,2,2,2,7,7,0,2024-01-06 04:34:00,0
5208,5208,5208,5208,2028,24,220,24,144,2028,76,24,129,121,120,24,24,220,76,27,27,0,24,3,3,3,3,3,2,2,2,2,8,8,0,2024-01-06 04:36:00,0
5151,5170,5151,5151,2016,24,205,24,145,2016,60,24,119,117,117,24,24,205,60,28,28,0,24,4,4,4,4,3,0,2,2,2,2,2,1,2024-01-06 04:38:00,0
5182,5182,5182,5182,2027,24,205,24,145,2027,60,24,125,119,119,24,24,205,60,28,28,0,24,4,4,4,4,4,0,2,2,2,6,6,0,2024-01-06 04:40:00,0
5172,5173,5172,5172,2026,24,199,24,148,2026,51,24,122,120,118,24,24,199,51,31,31,0,24,7,7,7,7,7,4,2,2,2,2,2,0,2024-01-06 04:42:00,0
5184,5183,5183,5183,2028,22,204,22,145,2028,59,22,127,121,119,22,22,204,59,28,28,0,22,4,4,4,4,4,4,2,2,2,6,6,0,2024-01-06 04:44:00,0
5160,5160,5160,5160,2019,24,196,24,145,2019,51,24,123,118,118,24,24,196,51,28,28,0,24,4,4,4,4,4,0,2,2,2,5,5,0,2024-01-06 04:46:00,0
5177,5178,5178,5178,2029,24,200,24,148,2029,52,24,122,119,118,24,24,200,52,31,31,0,24,7,7,7,7,6,2,2,2,2,3,3,1,2024-01-06 04:48:00,0
5176,5176,5176,5176,2025,24,256,24,147,2025,109,24,122,120,119,24,24,256,58,29,29,0,24,5,5,4,4,4,2,2,2,2,2,2,0,2024-01-06 04:50:00,52
5496,5495,5495,5495,2017,70,262,70,189,2017,73,70,166,162,161,70,70,262,73,27,27,0,70,3,3,3,3,3,2,2,2,2,4,4,0,2024-01-06 04:52:00,0
5677,5678,5678,5678,2033,94,275,94,206,2033,69,94,196,194,194,94,94,275,69,28,28,0,94,4,4,4,4,3,0,2,2,2,2,2,1,2024-01-06 04:54:00,0
5644,5642,5642,5642,2021,93,282,93,219,2021,63,93,197,189,188,93,93,282,63,32,32,0,93,8,8,8,8,8,2,2,2,2,8,8,0,2024-01-06 04:56:00,0
5661,5661,5660,5660,2027,96,293,96,210,2027,83,96,189,186,186,96,96,293,83,27,27,0,96,3,3,3,3,3,0,2,2,2,3,3,0,2024-01-06 04:58:00,0
5608,5611,5611,5611,2004,98,266,98,201,2004,65,98,190,188,184,98,98,266,65,27,27,0,98,4,4,4,4,4,8,2,2,2,2,2,0,2024-01-06 05:00:00,0
5641,5640,5640,5640,2014,93,286,93,214,2014,72,93,197,192,188,93,93,286,72,31,31,0,93,7,7,7,7,7,8,2,2,2,5,5,0,2024-01-06 05:02:00,0
5643,5644,5644,5644,2034,91,253,91,200,2034,53,91,181,181,180,91,91,253,53,28,28,0,91,4,4,4,4,3,2,2,2,2,0,0,1,2024-01-06 05:04:00,0
5636,5636,5636,5636,2030,88,266,88,212,2030,54,88,192,190,190,88,88,266,54,28,28,0,88,4,4,4,4,4,0,2,2,2,2,2,0,2024-01-06 05:06:00,0
5631,5630,5630,5630,2031,91,264,91,213,2031,51,91,185,183,183,91,91,264,51,28,28,0,91,4,4,4,4,3,0,2,2,2,2,2,1,2024-01-06 05:08:00,0
5660,5660,5660,5660,2027,100,284,100,219,2027,65,100,192,192,192,100,100,284,65,31,31,0,100,7,7,7,7,7,0,2,2,2,0,0,0,2024-01-06 05:10:00,0
5667,5668,5668,5668,2034,89,285,89,220,2034,65,89,189,186,185,89,89,285,65,28,28,0,89,4,4,4,4,4,2,2,2,2,3,3,0,2024-01-06 05:12:00,0
5649,5649,5649,5649,2019,93,276,93,208,2019,68,93,189,188,187,93,93,276,68,27,27,0,93,3,3,3,3,3,2,2,2,2,1,1,0,2024-01-06 05:14:00,0
5637,5635,5635,5635,2026,94,284,94,209,2026,75,94,186,184,183,94,94,284,75,28,28,0,94,4,4,4,4,4,2,2,2,2,2,2,0,2024-01-06 05:16:00,0
5611,5611,5611,5611,2024,85,265,85,209,2024,56,85,190,189,188,85,85,265,56,31,31,0,85,7,7,7,7,7,2,2,2,2,1,1,0,2024-01-06 05:18:00,0
5613,5615,5615,5615,2026,93,261,93,210,2026,51,93,191,188,186,93,93,261,51,28,28,0,93,4,4,4,4,3,4,2,2,2,3,3,1,2024-01-06 05:20:00,0
5652,5650,5650,5650,2021,90,276,90,215,2021,61,90,200,196,196,90,90,276,61,28,28,0,90,4,4,4,4,4,0,2,2,2,4,4,0,2024-01-06 05:22:00,0
5668,5670,5670,5670,2040,92,291,92,218,2040,73,92,193,191,189,92,92,291,73,31,31,0,92,7,7,7,7,6,4,2,2,2,2,2,1,2024-01-06 05:24:00,0
5639,5638,5638,5638,2014,96,285,96,215,2014,70,96,193,186,184,96,96,285,70,28,28,0,96,4,4,4,4,4,4,2,2,2,7,7,0,2024-01-06 05:26:00,0
5638,5638,5638,5638,2029,96,268,96,213,2029,55,96,196,192,189,96,96,268,55,28,28,0,96,4,4,4,4,4,6,2,2,2,4,4,0,2024-01-06 05:28:00,0
5643,5644,5644,5644,2027,89,274,89,213,2027,61,89,192,188,185,89,89,274,61,27,27,0,89,3,3,3,3,3,6,2,2,2,4,4,0,2024-01-06 05:30:00,0
5633,5633,5633,5633,2026,88,276,88,218,2026,58,88,187,185,184,88,88,276,58,32,32,0,88,8,8,8,8,8,2,2,2,2,2,2,0,2024-01-06 05:32:00,0
5628,5628,5628,5628,2027,86,280,86,212,2027,68,86,191,186,184,86,86,280,68,27,27,0,86,3,3,3,3,3,4,2,2,2,5,5,0,2024-01-06 05:34:00,0
5639,5637,5637,5637,2023,96,283,96,218,2023,65,96,192,187,185,96,96,283,65,28,28,0,96,4,4,4,4,3,4,2,2,2,5,5,1,2024-01-06 05:36:00,0
5647,5649,5649,5649,2030,95,282,95,209,2030,73,95,187,187,186,95,95,282,73,31,31,0,95,7,7,7,7,7,2,2,2,2,0,0,0,2024-01-06 05:38:00,0
5644,5643,5643,5643,2021,90,272,89,223,2021,49,89,205,204,203,89,89,272,49,28,28,0,89,4,4,4,4,3,2,2,2,2,1,1,1,2024-01-06 05:40:00,0
5638,5638,5638,5638,2011,92,282,93,217,2011,65,93,199,195,192,93,93,282,65,28,28,0,93,4,4,4,4,4,6,2,2,2,4,4,0,2024-01-06 05:42:00,0
5641,5642,5642,5642,2037,98,254,98,203,2037,51,98,191,188,186,98,98,254,51,28,28,0,98,4,4,4,4,4,4,2,2,2,3,3,0,2024-01-06 05:44:00,0
5629,5629,5629,5629,2037,95,270,95,214,2037,56,95,177,177,175,95,95,270,56,31,31,0,95,7,7,7,7,7,4,2,2,2,0,0,0,2024-01-06 05:46:00,0
5659,5657,5657,5657,2027,91,257,91,212,2027,45,91,192,188,188,91,91,257,45,28,28,0,91,4,4,4,4,4,0,2,2,2,4,4,0,2024-01-06 05:48:00,0
5558,5560,5560,5560,2014,93,291,93,209,2014,82,93,184,181,179,93,93,291,31,29,29,0,93,5,5,4,4,3,4,2,2,2,3,3,1,2024-01-06 05:50:00,52
5670,5670,5670,5670,2022,96,284,96,221,2022,63,96,195,193,192,96,96,284,63,27,27,0,96,3,3,3,3,3,2,2,2,2,2,2,0,2024-01-06 05:52:00,0
5652,5652,5652,5652,2036,96,265,96,209,2036,56,96,195,193,191,96,96,265,56,31,31,0,96,7,7,7,7,7,4,2,2,2,2,2,0,2024-01-06 05:54:00,0
5628,5628,5628,5628,2018,91,269,91,221,2018,48,91,183,182,181,91,91,269,48,28,28,0,91,4,4,4,4,3,2,2,2,2,1,1,1,2024-01-06 05:56:00,0
5633,5633,5633,5633,2025,93,259,93,208,2025,51,93,196,194,193,93,93,259,51,28,28,0,93,4,4,4,4,4,2,2,2,2,2,2,0,2024-01-06 05:58:00,0
5659,5659,5659,5659,2024,87,273,87,211,2024,62,87,204,198,194,87,87,273,62,31,31,0,87,7,7,7,7,7,8,2,2,2,6,6,0,2024-01-06 06:00:00,0
5606,5607,5606,5606,2006,91,276,91,216,2006,60,91,191,185,185,91,91,276,60,28,28,0,91,4,4,4,4,4,0,2,2,2,6,6,0,2024-01-06 06:02:00,0
5604,5604,5604,5604,2019,90,269,90,209,2019,60,90,180,177,176,90,90,269,60,28,28,0,90,4,4,4,4,4,2,2,2,2,3,3,0,2024-01-06 06:04:00,0
5675,5673,5673,5673,2031,91,277,91,213,2031,64,91,201,199,196,91,91,277,64,28,28,0,91,4,4,4,4,3,6,2,2,2,2,2,1,2024-01-06 06:06:00,0
5635,5636,5636,5636,2022,94,264,94,211,2022,53,94,197,190,189,94,94,264,53,32,32,0,94,7,7,7,7,7,2,2,2,2,7,7,0,2024-01-06 06:08:00,2
5635,5635,5635,5635,2020,90,267,90,198,2020,69,90,197,193,192,90,90,267,69,27,27,0,90,3,3,3,3,3,2,2,2,2,4,4,0,2024-01-06 06:10:00,0
5639,5640,5640,5640,2024,85,278,85,209,2024,69,85,186,182,180,85,85,278,69,28,28,0,85,4,4,4,4,3,4,2,2,2,4,4,1,2024-01-06 06:12:00,0
5608,5607,5607,5607,2011,101,286,101,216,2011,70,101,196,192,191,101,101,286,70,32,32,0,101,8,8,8,8,8,2,2,2,2,4,4,0,2024-01-06 06:14:00,0
5634,5635,5635,5635,2027,82,283,82,206,2027,77,82,191,189,187,82,82,283,77,27,27,0,82,3,3,3,3,3,4,2,2,2,2,2,0,2024-01-06 06:16:00,0
5672,5672,5672,5672,2031,93,268,93,213,2031,55,93,197,193,190,93,93,268,55,28,28,0,93,4,4,4,4,4,6,2,2,2,4,4,0,2024-01-06 06:18:00,0
5664,5663,5663,5663,2027,94,273,94,207,2027,66,94,192,190,189,94,94,273,66,28,28,0,94,4,4,4,4,4,2,2,2,2,2,2,0,2024-01-06 06:20:00,0
5647,5646,5646,5646,2020,109,281,108,216,2020,65,108,199,194,191,108,108,281,65,31,31,0,108,7,7,7,7,6,6,2,2,2,5,5,1,2024-01-06 06:22:00,0
5636,5637,5637,5637,2024,92,273,93,211,2024,62,93,200,197,195,93,93,273,62,28,28,0,93,4,4,4,4,4,4,2,2,2,3,3,0,2024-01-06 06:24:00,0
5623,5624,5624,5624,2026,89,268,89,212,2026,56,89,185,185,184,89,89,268,56,28,28,0,89,4,4,4,4,3,2,2,2,2,0,0,1,2024-01-06 06:26:00,0
5637,5657,5637,5637,2030,92,269,92,212,2030,57,92,196,193,193,92,92,269,57,31,31,0,92,7,7,7,7,7,0,2,2,2,3,3,0,2024-01-06 06:28:00,0
5641,5640,5640,5640,2028,95,280,95,216,2028,64,95,198,191,190,95,95,280,64,28,28,0,95,4,4,4,4,4,2,2,2,2,7,7,0,2024-01-06 06:30:00,0
5654,5655,5655,5655,2028,86,296,86,207,2028,89,86,183,182,181,86,86,296,89,27,27,0,86,3,3,3,3,3,2,2,2,2,1,1,0,2024-01-06 06:32:00,0
5617,5636,5617,5617,2012,86,270,86,219,2012,51,86,188,186,184,86,86,270,51,28,28,0,86,4,4,4,4,4,4,2,2,2,2,2,0,2024-01-06 06:34:00,0
5665,5665,5665,5665,2035,94,268,94,212,2035,56,94,191,186,185,94,94,268,56,31,31,0,94,7,7,7,7,7,2,2,2,2,5,5,0,2024-01-06 06:36:00,0
5605,5605,5605,5605,2012,105,276,105,221,2012,55,105,189,186,184,105,105,276,55,28,28,0,105,4,4,4,4,3,4,2,2,2,3,3,1,2024-01-06 06:38:00,0
5630,5629,5630,5630,2024,97,276,97,213,2024,63,97,190,185,184,97,97,276,63,28,28,0,97,4,4,4,4,4,2,2,2,2,5,5,0,2024-01-06 06:40:00,0
5646,5647,5646,5646,2029,102,284,102,222,2029,62,102,197,192,191,102,102,284,62,28,28,0,102,4,4,4,4,3,2,2,2,2,5,5,1,2024-01-06 06:42:00,0
5662,5661,5661,5661,2028,98,282,98,214,2028,68,98,181,176,176,98,98,282,68,31,31,0,98,7,7,7,7,7,0,2,2,2,5,5,0,2024-01-06 06:44:00,0
5663,5664,5664,5664,2032,96,275,96,219,2032,56,96,194,191,191,96,96,275,56,28,28,0,96,4,4,4,4,4,0,2,2,2,3,3,0,2024-01-06 06:46:00,0
5646,5645,5645,5645,2029,87,262,87,217,2029,45,87,191,190,189,87,87,262,45,27,27,0,87,3,3,3,3,3,2,2,2,2,1,1,0,2024-01-06 06:48:00,0
5616,5617,5617,5617,2025,92,323,92,214,2025,109,92,184,179,179,92,92,323,58,33,33,0,92,9,9,8,8,8,0,2,2,2,5,5,0,2024-01-06 06:50:00,52
5621,5621,5621,5621,2031,82,270,82,215,2031,55,82,189,184,183,82,82,270,55,27,27,0,82,3,3,3,3,3,2,2,2,2,5,5,0,2024-01-06 06:52:00,0
5632,5632,5632,5632,2019,88,273,88,222,2019,51,88,197,194,193,88,88,273,51,28,28,0,88,4,4,4,4,3,2,2,2,2,3,3,1,2024-01-06 06:54:00,0
5665,5665,5665,5665,2033,85,288,85,213,2033,75,85,195,195,194,85,85,288,75,28,28,0,85,4,4,4,4,4,2,2,2,2,0,0,0,2024-01-06 06:56:00,0
5629,5629,5629,5629,2023,88,273,88,221,2023,52,88,204,198,197,88,88,273,52,31,31,0,88,7,7,7,7,6,2,2,2,2,6,6,1,2024-01-06 06:58:00,0
5590,5609,5589,5589,2012,90,277,90,215,2012,62,90,191,186,184,90,90,277,62,28,28,0,90,4,4,4,4,4,4,2,2,2,5,5,0,2024-01-06 07:00:00,0
5639,5640,5640,5640,2010,103,390,103,212,2010,178,103,186,184,181,103,103,390,178,28,28,0,103,4,4,4,4,4,6,2,2,2,2,2,0,2024-01-06 07:02:00,0
5632,5632,5632,5632,2024,91,284,91,218,2024,66,91,185,182,182,91,91,284,66,31,31,0,91,7,7,7,7,7,0,2,2,2,3,3,0,2024-01-06 07:04:00,0
5671,5670,5670,5670,2033,82,288,82,211,2033,77,82,192,190,190,82,82,288,77,28,28,0,82,4,4,4,4,4,0,2,2,2,2,2,0,2024-01-06 07:06:00,0
5681,5700,5681,5681,2026,104,292,104,219,2026,73,104,193,189,186,104,104,292,73,27,27,0,104,3,3,3,3,3,6,2,2,2,4,4,0,2024-01-06 07:08:00,0
5672,5673,5673,5673,2030,96,298,96,215,2030,83,96,194,189,188,96,96,298,83,28,28,0,96,4,4,4,4,3,2,2,2,2,5,5,1,2024-01-06 07:10:00,0
5652,5651,5651,5651,2037,89,282,89,218,2037,64,89,192,189,188,89,89,282,64,31,31,0,89,7,7,7,7,7,2,2,2,2,3,3,0,2024-01-06 07:12:00,0
5649,5649,5649,5649,2032,91,276,91,215,2032,61,91,181,179,178,91,91,276,61,28,28,0,91,4,4,4,4,3,2,2,2,2,2,2,1,2024-01-06 07:14:00,0
5688,5689,5689,5689,2032,84,288,84,209,2032,79,84,193,190,189,84,84,288,79,28,28,0,84,4,4,4,4,4,2,2,2,2,3,3,0,2024-01-06 07:16:00,0
5620,5620,5620,5620,2026,84,285,84,227,2026,58,84,187,185,183,84,84,285,58,28,28,0,84,4,4,4,4,4,4,2,2,2,2,2,0,2024-01-06 07:18:00,0
5679,5679,5679,5679,2023,98,284,98,214,2023,70,98,210,205,201,98,98,284,70,31,31,0,98,7,7,7,7,7,8,2,2,2,5,5,0,2024-01-06 07:20:00,0
5665,5665,5665,5665,2017,100,285,100,223,2017,62,100,198,198,195,100,100,285,62,28,28,0,100,4,4,4,4,4,6,2,2,2,0,0,0,2024-01-06 07:22:00,0
5615,5615,5615,5615,2021,93,263,93,207,2021,56,93,185,183,183,93,93,263,56,28,28,0,93,4,4,4,4,3,0,2,2,2,2,2,1,2024-01-06 07:24:00,0
5562,5562,5562,5562,2001,81,264,81,214,2001,50,81,193,189,187,81,81,264,50,31,31,0,81,7,7,7,7,7,4,2,2,2,4,4,0,2024-01-06 07:26:00,0
5660,5660,5660,5660,2027,94,279,94,215,2027,64,94,191,186,185,94,94,279,64,27,27,0,94,3,3,3,3,3,2,2,2,2,5,5,0,2024-01-06 07:28:00,0
5688,5687,5687,5687,2027,99,289,99,218,2027,71,99,192,189,189,99,99,289,71,28,28,0,99,4,4,4,4,3,0,2,2,2,3,3,1,2024-01-06 07:30:00,0
5591,5592,5592,5592,2018,92,259,92,208,2018,51,92,181,178,177,92,92,259,51,28,28,0,92,4,4,4,4,4,2,2,2,2,3,3,0,2024-01-06 07:32:00,0
5650,5648,5648,5648,2038,87,279,87,217,2038,62,87,181,179,177,87,87,279,62,31,31,0,87,7,7,7,7,7,4,2,2,2,2,2,0,2024-01-06 07:34:00,0
5686,5687,5687,5687,2025,107,282,107,216,2025,66,107,200,198,196,107,107,282,66,28,28,0,107,4,4,4,4,4,4,2,2,2,2,2,0,2024-01-06 07:36:00,0
5625,5626,5626,5626,2025,93,269,93,215,2025,54,93,195,191,190,93,93,269,54,28,28,0,93,4,4,4,4,4,2,2,2,2,4,4,0,2024-01-06 07:38:00,0
5668,5668,5668,5668,2032,90,301,90,222,2032,79,90,186,184,183,90,90,301,79,31,31,0,90,7,7,7,7,6,2,2,2,2,2,2,1,2024-01-06 07:40:00,0
5629,5629,5629,5629,2024,102,264,102,213,2024,51,102,190,187,187,102,102,264,51,28,28,0,102,4,4,4,4,4,0,2,2,2,3,3,0,2024-01-06 07:42:00,0
5668,5668,5668,5668,2029,95,272,95,212,2029,60,95,198,197,196,95,95,272,60,27,27,0,95,3,3,3,3,3,2,2,2,2,1,1,0,2024-01-06 07:44:00,0
5688,5687,5687,5687,2035,94,281,94,221,2035,60,94,192,190,188,94,94,281,60,28,28,0,94,4,4,4,4,3,4,2,2,2,2,2,1,2024-01-06 07:46:00,0
5586,5586,5586,5586,2007,90,266,90,217,2007,49,90,187,185,182,90,90,266,49,31,31,0,90,8,8,8,8,8,6,2,2,2,2,2,0,2024-01-06 07:48:00,0
5657,5657,5657,5657,2036,85,324,85,212,2036,112,85,194,193,188,85,85,324,61,28,28,0,85,4,4,3,3,3,10,2,2,2,1,1,0,2024-01-06 07:50:00,52
5643,5644,5644,5644,2023,92,281,92,218,2023,63,92,190,188,187,92,92,281,63,28,28,0,92,4,4,4,4,4,2,2,2,2,2,2,0,2024-01-06 07:52:00,0
5661,5661,5661,5661,2032,95,280,95,211,2032,69,95,203,196,194,95,95,280,69,28,28,0,95,4,4,4,4,4,4,2,2,2,7,7,0,2024-01-06 07:54:00,0
5650,5650,5650,5650,2032,83,264,83,212,2032,52,83,197,193,193,83,83,264,52,33,33,0,83,7,7,7,7,6,0,2,2,2,4,4,1,2024-01-06 07:56:00,4
5670,5670,5670,5670,2030,91,282,91,227,2030,55,91,196,193,188,91,91,282,55,28,28,0,91,4,4,4,4,4,10,2,2,2,3,3,0,2024-01-06 07:58:00,0
5646,5666,5646,5646,2018,95,279,95,211,2018,68,95,200,196,193,95,95,279,68,28,28,0,95,4,4,4,4,3,6,2,2,2,4,4,1,2024-01-06 08:00:00,0
5627,5626,5626,5626,2019,93,286,93,220,2019,66,93,186,182,179,93,93,286,66,31,31,0,93,7,7,7,7,7,6,2,2,2,4,4,0,2024-01-06 08:02:00,0
5662,5663,5663,5663,2019,96,291,96,213,2019,78,96,192,190,187,96,96,291,78,28,28,0,96,4,4,4,4,4,6,2,2,2,2,2,0,2024-01-06 08:04:00,0
5618,5617,5617,5617,2018,101,266,101,209,2018,57,101,195,192,192,101,101,266,57,27,27,0,101,3,3,3,3,3,0,2,2,2,3,3,0,2024-01-06 08:06:00,0
5642,5643,5643,5643,2029,92,286,92,216,2029,70,92,187,184,183,92,92,286,70,28,28,0,92,4,4,4,4,4,2,2,2,2,3,3,0,2024-01-06 08:08:00,0
5644,5644,5644,5644,2026,96,262,96,212,2026,50,96,195,191,189,96,96,262,50,31,31,0,96,7,7,7,7,7,4,2,2,2,4,4,0,2024-01-06 08:10:00,0
5620,5639,5619,5619,2010,83,273,83,210,2010,63,83,197,194,192,83,83,273,63,28,28,0,83,4,4,4,4,3,4,2,2,2,3,3,1,2024-01-06 08:12:00,0
5678,5679,5679,5679,2029,90,295,90,226,2029,69,90,188,184,181,90,90,295,69,28,28,0,90,4,4,4,4,4,6,2,2,2,4,4,0,2024-01-06 08:14:00,0
5641,5640,5640,5640,2026,97,286,97,220,2026,66,97,192,190,187,97,97,286,66,31,31,0,97,7,7,7,7,6,6,2,2,2,2,2,1,2024-01-06 08:16:00,0
5667,5668,5668,5668,2030,92,286,92,213,2030,73,92,209,202,201,92,92,286,73,28,28,0,92,4,4,4,4,4,2,2,2,2,7,7,0,2024-01-06 08:18:00,0
5642,5643,5642,5642,2024,91,272,91,211,2024,61,91,192,189,184,91,91,272,61,28,28,0,91,4,4,4,4,4,10,2,2,2,3,3,0,2024-01-06 08:20:00,0
5640,5639,5639,5639,2008,113,273,113,210,2008,63,113,187,183,182,113,113,273,63,27,27,0,113,3,3,3,3,3,2,2,2,2,4,4,0,2024-01-06 08:22:00,0
5700,5720,5701,5701,2037,91,287,91,201,2037,86,91,201,196,194,91,91,287,86,32,32,0,91,8,8,8,8,8,4,2,2,2,5,5,0,2024-01-06 08:24:00,0
5674,5673,5673,5673,2043,96,269,96,219,2043,50,96,189,185,185,96,96,269,50,27,27,0,96,3,3,3,3,3,0,2,2,2,4,4,0,2024-01-06 08:26:00,0
5640,5640,5640,5640,2023,93,269,92,210,2023,59,92,192,190,186,92,92,269,59,28,28,0,92,4,4,4,4,3,8,2,2,2,2,2,1,2024-01-06 08:28:00,0
5655,5657,5656,5656,2032,90,275,91,209,2032,66,91,193,190,188,91,91,275,66,28,28,0,91,4,4,4,4,4,4,2,2,2,3,3,0,2024-01-06 08:30:00,0
5681,5680,5680,5680,2030,92,278,92,217,2030,61,92,196,193,189,92,92,278,61,31,31,0,92,7,7,7,7,6,8,2,2,2,3,3,1,2024-01-06 08:32:00,0
5605,5606,5606,5606,2006,90,282,90,220,2006,62,90,191,188,186,90,90,282,62,28,28,0,90,4,4,4,4,4,4,2,2,2,3,3,0,2024-01-06 08:34:00,0
5607,5607,5607,5607,2013,89,277,89,210,2013,67,89,193,189,188,89,89,277,67,28,28,0,89,4,4,4,4,4,2,2,2,2,4,4,0,2024-01-06 08:36:00,0
5686,5686,5686,5686,2028,90,295,90,216,2028,79,90,201,195,191,90,90,295,79,31,31,0,90,7,7,7,7,7,8,2,2,2,6,6,0,2024-01-06 08:38:00,0
5617,5617,5617,5617,2029,85,262,85,206,2029,56,85,184,183,183,85,85,262,56,28,28,0,85,4,4,4,4,4,0,2,2,2,1,1,0,2024-01-06 08:40:00,0
5658,5659,5658,5658,2021,80,276,80,204,2021,72,80,202,197,194,80,80,276,72,27,27,0,80,3,3,3,3,3,6,2,2,2,5,5,0,2024-01-06 08:42:00,0
5637,5637,5637,5637,2017,90,283,90,225,2017,58,90,183,182,181,90,90,283,58,28,28,0,90,4,4,4,4,3,2,2,2,2,1,1,1,2024-01-06 08:44:00,0
5670,5670,5670,5670,2030,90,286,90,216,2030,70,90,195,192,190,90,90,286,70,31,31,0,90,7,7,7,7,7,4,2,2,2,3,3,0,2024-01-06 08:46:00,0
5649,5645,5645,5645,2035,85,269,85,205,2035,64,85,196,188,187,85,85,269,64,28,28,0,85,4,4,4,4,3,2,2,2,2,8,8,1,2024-01-06 08:48:00,0
5647,5651,5651,5651,2028,92,327,92,229,2028,98,92,197,196,195,92,92,327,47,29,29,0,92,5,5,4,4,4,2,2,2,2,1,1,0,2024-01-06 08:50:00,52
5635,5635,5635,5635,2019,90,261,90,216,2019,45,90,186,183,181,90,90,261,45,31,31,0,90,7,7,7,7,7,4,2,2,2,3,3,0,2024-01-06 08:52:00,0
5640,5638,5638,5638,2028,88,283,88,219,2028,64,88,194,190,189,88,88,283,64,28,28,0,88,4,4,4,4,4,2,2,2,2,4,4,0,2024-01-06 08:54:00,0
5615,5617,5617,5617,2014,91,276,91,214,2014,62,91,191,188,186,91,91,276,62,28,28,0,91,4,4,4,4,4,4,2,2,2,3,3,0,2024-01-06 08:56:00,0
5694,5711,5692,5692,2027,104,278,104,210,2027,68,104,201,197,196,104,104,278,68,28,28,0,104,4,4,4,4,3,2,2,2,2,4,4,1,2024-01-06 08:58:00,0
5629,5630,5631,5631,2023,79,286,79,227,2023,59,79,184,181,180,79,79,286,59,31,31,0,79,7,7,7,7,7,2,2,2,2,3,3,0,2024-01-06 09:00:00,0
5618,5619,5618,5618,2016,93,369,93,212,2016,157,93,199,195,193,93,93,369,157,27,27,0,93,3,3,3,3,3,4,2,2,2,4,4,0,2024-01-06 09:02:00,0
5617,5617,5617,5617,2022,97,262,97,221,2022,41,97,188,186,182,97,97,262,41,28,28,0,97,4,4,4,4,3,8,2,2,2,2,2,1,2024-01-06 09:04:00,0
5662,5659,5659,5659,2041,88,286,88,210,2041,76,88,192,186,186,88,88,286,76,28,28,0,88,4,4,4,4,4,0,2,2,2,6,6,0,2024-01-06 09:06:00,0
5629,5632,5632,5632,2031,84,278,84,220,2031,58,84,190,186,182,84,84,278,58,31,31,0,84,7,7,7,7,7,8,2,2,2,4,4,0,2024-01-06 09:08:00,0
5666,5666,5666,5666,2030,93,282,93,210,2030,72,93,194,187,185,93,93,282,72,28,28,0,93,4,4,4,4,4,4,2,2,2,7,7,0,2024-01-06 09:10:00,0
5688,5707,5687,5687,2035,99,289,99,212,2035,77,99,198,193,188,99,99,289,77,28,28,0,99,4,4,4,4,4,10,2,2,2,5,5,0,2024-01-06 09:12:00,0
5643,5644,5644,5644,2022,92,279,92,209,2022,70,92,200,193,191,92,92,279,70,31,31,0,92,7,7,7,7,6,4,2,2,2,7,7,1,2024-01-06 09:14:00,0
5639,5639,5639,5639,2014,86,288,86,215,2014,73,86,196,190,187,86,86,288,73,28,28,0,86,4,4,4,4,4,6,2,2,2,6,6,0,2024-01-06 09:16:00,0
5679,5679,5679,5679,2034,88,300,88,221,2034,79,88,192,191,190,88,88,300,79,27,27,0,88,3,3,3,3,3,2,2,2,2,1,1,0,2024-01-06 09:18:00,0
5631,5631,5631,5631,2016,92,286,92,218,2016,68,92,189,189,188,92,92,286,68,28,28,0,92,4,4,4,4,3,2,2,2,2,0,0,1,2024-01-06 09:20:00,0
5638,5656,5637,5637,2017,104,285,104,214,2017,71,104,185,182,180,104,104,285,71,32,32,0,104,8,8,8,8,8,4,2,2,2,3,3,0,2024-01-06 09:22:00,0
5661,5662,5662,5662,2030,99,271,99,210,2030,61,99,189,185,183,99,99,271,61,27,27,0,99,3,3,3,3,3,4,2,2,2,4,4,0,2024-01-06 09:24:00,0
5656,5656,5656,5656,2023,90,277,90,219,2023,58,90,195,193,192,90,90,277,58,28,28,0,90,4,4,4,4,4,2,2,2,2,2,2,0,2024-01-06 09:26:00,0
5638,5637,5637,5637,2033,90,265,90,212,2033,53,90,189,188,187,90,90,265,53,28,28,0,90,4,4,4,4,4,2,2,2,2,1,1,0,2024-01-06 09:28:00,0
5616,5618,5617,5617,2020,88,278,88,214,2020,64,88,190,185,184,88,88,278,64,31,31,0,88,7,7,7,7,6,2,2,2,2,5,5,1,2024-01-06 09:30:00,0
5662,5662,5662,5662,2025,90,287,90,210,2025,77,90,188,184,181,90,90,287,77,28,28,0,90,4,4,4,4,4,6,2,2,2,4,4,0,2024-01-06 09:32:00,0
5645,5644,5644,5644,2012,96,272,96,208,2012,64,96,199,195,192,96,96,272,64,28,28,0,96,4,4,4,4,3,6,2,2,2,4,4,1,2024-01-06 09:34:00,0
5687,5687,5687,5687,2021,99,293,99,229,2021,64,99,202,199,197,99,99,293,64,31,31,0,99,7,7,7,7,7,4,2,2,2,3,3,0,2024-01-06 09:36:00,0
5640,5639,5639,5639,2024,91,263,91,207,2024,56,91,200,197,195,91,91,263,56,28,28,0,91,4,4,4,4,4,4,2,2,2,3,3,0,2024-01-06 09:38:00,0
5672,5673,5672,5672,2037,92,290,92,216,2037,74,92,192,189,189,92,92,290,74,27,27,0,92,3,3,3,3,3,0,2,2,2,3,3,0,2024-01-06 09:40:00,0
5664,5666,5666,5666,2026,93,289,93,214,2026,75,93,187,185,185,93,93,289,75,28,28,0,93,4,4,4,4,4,0,2,2,2,2,2,0,2024-01-06 09:42:00,0
5670,5669,5669,5669,2037,88,279,88,220,2037,59,88,189,185,182,88,88,279,59,31,31,0,88,7,7,7,7,7,6,2,2,2,4,4,0,2024-01-06 09:44:00,0
5550,5550,5550,5550,1993,88,273,88,205,1993,68,88,177,173,170,88,88,273,68,28,28,0,88,4,4,4,4,3,6,2,2,2,4,4,1,2024-01-06 09:46:00,0
5634,5634,5633,5633,2025,90,265,90,217,2025,48,90,188,185,185,90,90,265,48,30,30,0,90,5,4,4,4,4,0,2,2,2,3,3,0,2024-01-06 09:48:00,3
5641,5642,5642,5642,2036,87,326,87,224,2036,102,87,178,177,176,87,87,326,51,32,32,0,87,8,8,7,7,6,2,2,2,2,1,1,1,2024-01-06 09:50:00,52
5617,5618,5618,5618,2022,78,269,78,208,2022,61,78,208,201,199,78,78,269,61,28,28,0,78,4,4,4,4,4,4,2,2,2,7,7,0,2024-01-06 09:52:00,0
5664,5664,5664,5664,2024,104,288,104,225,2024,63,104,190,189,188,104,104,288,63,28,28,0,104,4,4,4,4,4,2,2,2,2,1,1,0,2024-01-06 09:54:00,0
5649,5649,5649,5649,2040,95,262,95,214,2040,48,95,182,180,178,95,95,262,48,27,27,0,95,3,3,3,3,3,4,2,2,2,2,2,0,2024-01-06 09:56:00,0
5633,5633,5633,5633,2016,100,281,100,214,2016,67,100,194,193,192,100,100,281,67,32,32,0,100,8,8,8,8,8,2,2,2,2,1,1,0,2024-01-06 09:58:00,0
5663,5663,5663,5663,2030,90,269,90,217,2030,52,90,193,192,192,90,90,269,52,27,27,0,90,3,3,3,3,3,0,2,2,2,1,1,0,2024-01-06 10:00:00,0
5629,5629,5629,5629,2015,95,281,95,224,2015,57,95,196,194,193,95,95,281,57,30,30,0,95,5,4,4,4,3,2,2,2,2,2,2,1,2024-01-06 10:02:00,3
5621,5619,5619,5619,2020,91,256,91,209,2020,47,91,194,189,187,91,91,256,47,28,28,0,91,4,4,4,4,4,4,2,2,2,5,5,0,2024-01-06 10:04:00,0
5647,5649,5649,5649,2016,106,288,106,215,2016,73,106,204,201,199,106,106,288,73,31,31,0,106,7,7,7,7,6,4,2,2,2,3,3,1,2024-01-06 10:06:00,0
5644,5644,5644,5644,2027,92,271,92,208,2027,63,92,193,190,185,92,92,271,63,28,28,0,92,4,4,4,4,4,10,2,2,2,3,3,0,2024-01-06 10:08:00,0
5588,5589,5588,5588,2005,82,291,82,208,2005,83,82,188,184,183,82,82,291,83,28,28,0,82,4,4,4,4,4,2,2,2,2,4,4,0,2024-01-06 10:10:00,0
5663,5662,5662,5662,2022,95,290,95,216,2022,74,95,188,185,183,95,95,290,74,31,31,0,95,7,7,7,7,7,4,2,2,2,3,3,0,2024-01-06 10:12:00,0
5645,5644,5644,5644,2033,83,278,83,209,2033,69,83,198,192,191,83,83,278,69,34,34,0,83,7,4,4,4,4,2,2,2,2,6,6,0,2024-01-06 10:14:00,9
5657,5659,5659,5659,2016,95,291,95,220,2016,71,95,191,187,187,95,95,291,71,27,27,0,95,3,3,3,3,3,0,2,2,2,4,4,0,2024-01-06 10:16:00,0
5643,5643,5643,5643,2018,102,268,102,215,2018,53,102,194,191,190,102,102,268,53,28,28,0,102,4,4,4,4,3,2,2,2,2,3,3,1,2024-01-06 10:18:00,0
5644,5644,5644,5644,2024,88,270,88,211,2024,59,88,197,193,190,88,88,270,59,31,31,0,88,7,7,7,7,7,6,2,2,2,4,4,0,2024-01-06 10:20:00,0
5701,5700,5701,5701,2033,88,323,88,249,2033,74,88,198,191,190,88,88,323,74,64,64,0,88,22,4,4,4,3,2,2,2,2,7,7,1,2024-01-06 10:22:00,54
5672,5672,5672,5672,2025,89,320,89,244,2025,76,89,201,196,194,89,89,320,76,58,58,0,89,19,4,4,4,4,4,2,2,2,5,5,0,2024-01-06 10:24:00,45
5660,5658,5658,5658,2020,102,293,102,226,2020,67,102,192,188,186,102,102,293,67,33,33,0,102,8,7,7,7,7,4,2,2,2,4,4,0,2024-01-06 10:26:00,3
5655,5655,5656,5656,2012,94,291,94,209,2012,82,94,196,193,190,94,94,291,82,28,28,0,94,4,4,4,4,4,6,2,2,2,3,3,0,2024-01-06 10:28:00,0
5654,5655,5655,5655,2031,96,281,96,216,2031,65,96,188,184,182,96,96,281,65,28,28,0,96,4,4,4,4,4,4,2,2,2,4,4,0,2024-01-06 10:30:00,0
5626,5624,5624,5624,2012,89,277,89,208,2012,69,89,201,199,198,89,88,277,69,27,27,4,89,4,4,4,4,3,2,2,2,2,2,2,1,2024-01-06 10:32:00,0
5629,5630,5630,5630,2009,92,316,92,226,2009,90,92,194,191,188,92,93,316,90,49,49,0,92,16,7,7,7,7,6,2,2,2,3,3,0,2024-01-06 10:34:00,27
5685,5686,5685,5685,2033,91,299,91,222,2033,77,91,198,191,190,91,91,299,77,27,27,7,91,3,3,3,3,3,2,2,2,2,7,7,0,2024-01-06 10:36:00,0
5721,5722,5722,5722,2032,89,318,89,212,2032,106,89,208,197,191,89,89,318,106,28,28,0,89,4,4,4,4,3,12,2,2,2,11,11,1,2024-01-06 10:38:00,0
5730,5728,5728,5728,2026,96,348,96,213,2026,135,96,204,196,193,96,96,348,135,28,28,0,96,4,4,4,4,4,6,2,2,2,8,8,0,2024-01-06 10:40:00,0
5673,5674,5675,5675,2015,85,322,85,217,2015,105,85,198,194,192,85,85,322,105,31,31,0,85,7,7,7,7,7,4,2,2,2,4,4,0,2024-01-06 10:42:00,0
5690,5690,5690,5690,2020,88,353,88,223,2020,130,88,191,188,186,88,88,353,130,30,30,0,88,5,4,4,4,4,4,2,2,2,3,3,0,2024-01-06 10:44:00,3
5680,5679,5679,5679,2016,95,327,90,218,2017,109,90,212,203,196,90,89,327,109,34,34,0,89,7,4,4,4,4,14,2,2,2,9,9,0,2024-01-06 10:46:00,11
5666,5687,5667,5667,2018,81,328,81,215,2018,113,81,196,185,181,81,81,328,113,31,31,0,81,7,7,7,7,6,8,2,2,2,11,11,1,2024-01-06 10:48:00,0
5624,5623,5623,5623,1998,96,364,96,210,1998,154,96,188,181,179,96,96,364,103,29,29,0,96,5,5,4,4,4,4,2,2,2,7,7,0,2024-01-06 10:50:00,52
5664,5665,5665,5665,2014,103,326,103,218,2014,108,103,186,181,178,103,103,326,108,27,27,0,103,3,3,3,3,3,6,2,2,2,5,5,0,2024-01-06 10:52:00,0
5681,5679,5679,5679,2012,89,341,89,212,2012,129,89,193,186,185,89,89,341,129,28,28,0,89,4,4,4,4,3,2,2,2,2,7,7,1,2024-01-06 10:54:00,0
5653,5653,5653,5653,2006,88,343,88,207,2006,136,88,198,192,188,88,88,343,136,32,32,0,88,8,8,8,8,8,8,2,2,2,6,6,0,2024-01-06 10:56:00,0
5719,5740,5720,5720,2023,97,347,92,212,2024,135,92,206,199,198,92,91,347,135,27,27,0,91,3,3,3,3,3,2,2,2,2,7,7,0,2024-01-06 10:58:00,2
5715,5716,5716,5716,2026,111,322,111,217,2026,105,111,195,193,190,111,111,322,105,28,28,0,111,4,4,4,4,4,6,2,2,2,2,2,0,2024-01-06 11:00:00,0
5726,5725,5725,5725,2016,89,552,89,216,2016,336,89,201,190,185,89,89,552,336,28,28,0,89,4,4,4,4,4,10,2,2,2,11,11,0,2024-01-06 11:02:00,0
5755,5756,5756,5756,2031,93,363,93,216,2031,147,93,210,203,200,93,93,363,147,31,31,3,93,7,7,7,7,6,6,2,2,2,7,7,1,2024-01-06 11:04:00,0
5691,5692,5691,5691,2022,94,334,94,209,2022,125,94,182,174,172,94,94,334,125,28,28,6,94,4,4,4,4,4,4,2,2,2,8,8,0,2024-01-06 11:06:00,0
5679,5680,5679,5679,2027,87,313,87,215,2027,98,87,197,193,191,87,87,313,98,28,28,0,87,4,4,4,4,3,4,2,2,2,4,4,1,2024-01-06 11:08:00,0
5750,5747,5747,5747,2023,90,370,90,207,2023,163,90,203,196,192,90,90,370,163,31,31,0,90,7,7,7,7,7,8,2,2,2,7,7,0,2024-01-06 11:10:00,0
5749,5750,5750,5750,2022,98,352,98,209,2022,143,98,201,195,188,98,98,352,143,28,28,10,98,4,4,4,4,4,14,2,2,2,6,6,0,2024-01-06 11:12:00,0
5700,5703,5702,5702,2019,94,362,94,217,2019,145,94,184,181,178,94,94,362,145,27,27,4,94,3,3,3,3,3,6,2,2,2,3,3,0,2024-01-06 11:14:00,0
5666,5667,5666,5666,2020,88,328,88,203,2020,125,88,202,200,197,88,88,328,125,28,28,0,88,4,4,4,4,4,6,2,2,2,2,2,0,2024-01-06 11:16:00,0
5682,5683,5682,5682,2010,89,363,89,221,2010,142,89,203,194,189,89,89,363,142,31,31,0,89,7,7,7,7,7,10,2,2,2,9,9,0,2024-01-06 11:18:00,0
5736,5735,5735,5735,2030,94,341,94,212,2030,129,94,200,194,192,94,94,341,129,28,28,0,94,4,4,4,4,3,4,2,2,2,6,6,1,2024-01-06 11:20:00,0
5667,5671,5668,5668,2018,88,347,88,214,2018,133,88,189,182,180,88,88,347,133,28,28,11,88,4,4,4,4,4,4,2,2,2,7,7,0,2024-01-06 11:22:00,0
5741,5740,5740,5740,2034,96,337,96,214,2034,123,96,203,200,196,96,96,337,123,28,28,0,96,4,4,4,4,3,8,2,2,2,3,3,1,2024-01-06 11:24:00,0
5735,5734,5734,5734,2029,88,353,88,229,2029,124,88,202,198,194,88,88,353,124,31,31,0,88,7,7,7,7,7,8,2,2,2,4,4,0,2024-01-06 11:26:00,0
5735,5736,5736,5736,2019,101,371,101,215,2019,156,101,201,195,193,101,101,371,156,28,28,0,101,4,4,4,4,4,4,2,2,2,6,6,0,2024-01-06 11:28:00,0
5682,5683,5683,5683,2019,85,331,85,215,2019,116,85,204,196,193,85,85,331,116,27,27,0,85,3,3,3,3,3,6,2,2,2,8,8,0,2024-01-06 11:30:00,0
5724,5745,5724,5724,2024,97,368,97,223,2024,145,97,198,188,185,97,97,368,145,32,32,10,97,8,8,8,8,8,6,2,2,2,10,10,0,2024-01-06 11:32:00,0
5680,5680,5679,5679,2021,84,347,79,217,2022,130,79,196,186,183,79,78,347,130,27,27,8,78,3,3,3,3,3,6,2,2,2,10,10,0,2024-01-06 11:34:00,2
5700,5701,5701,5701,2034,88,334,88,211,2034,123,88,198,190,189,88,88,334,123,28,28,1,88,4,4,4,4,3,2,2,2,2,8,8,1,2024-01-06 11:36:00,0
5732,5731,5731,5731,2033,78,369,78,211,2033,158,78,213,203,199,78,78,369,158,28,28,13,78,4,4,4,4,4,8,2,2,2,10,10,0,2024-01-06 11:38:00,0
5687,5688,5687,5687,2018,95,344,95,207,2018,137,95,198,193,188,95,95,344,137,31,31,0,95,7,7,7,7,6,10,2,2,2,5,5,1,2024-01-06 11:40:00,0
5639,5640,5639,5639,1987,114,360,109,211,1988,149,109,192,182,178,109,108,360,149,28,28,4,108,4,4,4,4,4,8,2,2,2,10,10,0,2024-01-06 11:42:00,2
5688,5689,5688,5688,2027,82,328,82,203,2027,125,82,197,189,185,82,82,328,125,28,28,0,82,4,4,4,4,4,8,2,2,2,8,8,0,2024-01-06 11:44:00,0
5711,5710,5710,5710,2016,90,356,85,221,2017,135,85,193,193,191,85,84,356,135,27,27,0,84,3,3,3,3,3,4,2,2,2,0,0,0,2024-01-06 11:46:00,4
5726,5727,5727,5727,2024,84,336,84,224,2024,112,84,201,195,191,84,84,336,112,32,32,4,84,8,8,8,8,8,8,2,2,2,6,6,0,2024-01-06 11:48:00,0
5666,5664,5664,5664,2029,88,366,88,223,2029,143,88,180,179,178,88,88,366,92,28,28,0,88,4,4,3,3,3,2,2,2,2,1,1,0,2024-01-06 11:50:00,52
5695,5697,5697,5697,2025,81,327,81,207,2025,120,81,198,192,191,81,81,327,120,28,28,9,81,4,4,4,4,3,2,2,2,2,6,6,1,2024-01-06 11:52:00,0
5726,5725,5723,5723,2023,96,332,96,211,2023,121,96,217,200,192,96,96,332,121,31,31,1,96,7,7,7,7,7,16,2,2,2,17,17,0,2024-01-06 11:54:00,0
5766,5772,5768,5768,2027,83,389,83,216,2027,173,83,195,186,182,83,83,389,173,28,28,1,83,4,4,4,4,3,8,2,2,2,9,9,1,2024-01-06 11:56:00,0
5698,5700,5700,5700,2031,90,315,90,208,2031,107,90,201,196,193,90,90,315,107,28,28,2,90,4,4,4,4,4,6,2,2,2,5,5,0,2024-01-06 11:58:00,0
5685,5684,5684,5684,2016,95,330,95,210,2016,120,95,195,183,180,95,95,330,120,28,28,0,95,4,4,4,4,4,6,2,2,2,12,12,0,2024-01-06 12:00:00,0
5739,5738,5738,5738,2012,93,575,93,221,2012,354,93,209,201,196,93,93,575,354,31,31,0,93,7,7,7,7,7,10,2,2,2,8,8,0,2024-01-06 12:02:00,0
5709,5711,5711,5711,2020,93,378,93,214,2020,164,93,192,181,174,93,93,378,164,28,28,2,93,4,4,4,4,4,14,2,2,2,11,11,0,2024-01-06 12:04:00,0
5718,5716,5716,5716,2028,84,359,83,213,2028,146,83,200,191,187,83,83,359,146,28,28,0,83,4,4,4,4,3,8,2,2,2,9,9,1,2024-01-06 12:06:00,0
5735,5737,5737,5737,2020,95,353,96,212,2020,141,96,210,203,198,96,96,353,141,27,27,6,96,3,3,3,3,3,10,2,2,2,7,7,0,2024-01-06 12:08:00,0
5733,5731,5731,5731,2033,87,341,87,220,2033,121,87,199,192,189,87,87,341,121,31,31,12,87,7,7,7,7,7,6,2,2,2,7,7,0,2024-01-06 12:10:00,0
5774,5776,5776,5776,2021,104,382,104,208,2021,174,104,208,197,192,104,104,382,174,28,28,0,104,4,4,4,4,3,10,2,2,2,11,11,1,2024-01-06 12:12:00,0
5695,5695,5695,5695,2024,92,341,92,218,2024,123,92,195,193,188,92,92,341,123,28,28,16,92,4,4,4,4,4,10,2,2,2,2,2,0,2024-01-06 12:14:00,0
5731,5730,5730,5730,2028,85,372,85,221,2028,151,85,194,191,187,85,85,372,151,31,31,1,85,7,7,7,7,7,8,2,2,2,3,3,0,2024-01-06 12:16:00,0
5750,5750,5750,5750,2025,96,371,96,221,2025,150,96,196,188,186,96,96,371,150,28,28,4,96,4,4,4,4,4,4,2,2,2,8,8,0,2024-01-06 12:18:00,0
5732,5733,5732,5732,2022,88,350,88,224,2022,126,88,192,186,179,88,88,350,126,28,28,0,88,4,4,4,4,4,14,2,2,2,6,6,0,2024-01-06 12:20:00,0
5702,5701,5701,5701,2013,91,350,91,211,2013,139,91,195,187,182,91,91,350,139,28,28,0,91,4,4,4,4,3,10,2,2,2,8,8,1,2024-01-06 12:22:00,0
5741,5743,5743,5743,2028,103,357,103,219,2028,138,103,202,192,188,103,103,357,138,31,31,0,103,7,7,7,7,7,8,2,2,2,10,10,0,2024-01-06 12:24:00,0
5752,5752,5752,5752,2028,102,369,102,214,2028,155,102,192,183,181,102,102,369,155,27,27,0,102,3,3,3,3,3,4,2,2,2,9,9,0,2024-01-06 12:26:00,0
5673,5672,5672,5672,2003,82,339,82,209,2003,130,82,207,200,196,82,82,339,130,28,28,1,82,4,4,4,4,3,8,2,2,2,7,7,1,2024-01-06 12:28:00,0
5683,5684,5684,5684,2020,90,329,90,206,2020,123,90,195,185,180,90,90,329,123,28,28,1,90,4,4,4,4,4,10,2,2,2,10,10,0,2024-01-06 12:30:00,0
5698,5697,5697,5697,2026,93,332,93,218,2026,114,93,189,186,183,93,93,332,114,31,31,0,93,7,7,7,7,7,6,2,2,2,3,3,0,2024-01-06 12:32:00,0
5746,5747,5747,5747,2018,98,346,98,210,2018,136,98,197,190,187,98,98,346,136,28,28,0,98,4,4,4,4,4,6,2,2,2,7,7,0,2024-01-06 12:34:00,0
5724,5722,5722,5722,2020,86,366,86,215,2020,151,86,197,193,189,86,86,366,151,28,28,1,86,4,4,4,4,4,8,2,2,2,4,4,0,2024-01-06 12:36:00,0
5701,5702,5702,5702,2024,94,321,94,210,2024,111,94,195,192,184,94,94,321,111,28,28,0,94,4,4,4,4,3,16,2,2,2,3,3,1,2024-01-06 12:38:00,0
5674,5673,5673,5673,2026,81,323,81,208,2026,115,81,201,197,195,81,81,323,115,31,31,4,81,7,7,7,7,7,4,2,2,2,4,4,0,2024-01-06 12:40:00,0
5702,5703,5703,5703,2019,87,346,87,219,2019,127,87,195,191,187,87,87,346,127,27,27,0,87,3,3,3,3,3,8,2,2,2,4,4,0,2024-01-06 12:42:00,0
5750,5750,5750,5750,2034,97,343,97,204,2034,139,97,205,200,196,97,97,343,139,28,28,4,97,4,4,4,4,3,8,2,2,2,5,5,1,2024-01-06 12:44:00,0
5725,5746,5726,5726,2030,103,329,103,213,2030,116,103,181,175,172,103,103,329,116,28,28,0,103,4,4,4,4,4,6,2,2,2,6,6,0,2024-01-06 12:46:00,0
5664,5664,5664,5664,2012,95,329,95,210,2012,119,95,202,194,191,95,95,329,119,31,31,0,95,7,7,7,7,7,6,2,2,2,8,8,0,2024-01-06 12:48:00,0
5680,5678,5678,5678,2023,94,368,94,207,2023,161,94,198,194,191,94,94,368,110,29,29,4,94,5,5,4,4,4,6,2,2,2,4,4,0,2024-01-06 12:50:00,52
5672,5672,5672,5672,2029,90,304,90,207,2029,97,90,199,195,193,90,90,304,97,28,28,0,90,4,4,4,4,4,4,2,2,2,4,4,0,2024-01-06 12:52:00,0
5731,5733,5732,5732,2024,97,348,97,224,2024,124,97,190,181,177,97,97,348,124,31,31,4,97,7,7,7,7,6,8,2,2,2,9,9,1,2024-01-06 12:54:00,0
5753,5753,5753,5753,2035,83,370,83,216,2035,154,83,201,192,190,83,83,370,154,28,28,0,83,4,4,4,4,4,4,2,2,2,9,9,0,2024-01-06 12:56:00,0
5722,5722,5722,5722,2023,86,349,86,214,2023,135,86,203,200,195,86,86,349,135,27,27,0,86,3,3,3,3,3,10,2,2,2,3,3,0,2024-01-06 12:58:00,0
5714,5715,5715,5715,2034,101,330,101,217,2034,113,101,197,187,183,101,101,330,113,28,28,0,101,4,4,4,4,3,8,2,2,2,10,10,1,2024-01-06 13:00:00,0
5740,5739,5739,5739,2020,93,561,93,217,2020,344,93,197,190,186,93,93,561,344,32,32,0,93,8,8,8,8,8,8,2,2,2,7,7,0,2024-01-06 13:02:00,0
5676,5676,5676,5676,2024,100,313,100,211,2024,102,100,202,191,190,100,100,313,102,27,27,1,100,3,3,3,3,3,2,2,2,2,11,11,0,2024-01-06 13:04:00,0
5739,5739,5739,5739,2017,91,360,91,216,2017,144,91,191,184,181,91,91,360,144,28,28,1,91,4,4,4,4,4,6,2,2,2,7,7,0,2024-01-06 13:06:00,0
5745,5747,5745,5745,2030,84,363,84,226,2030,137,84,188,181,176,84,84,363,137,28,28,0,84,4,4,4,4,4,10,2,2,2,7,7,0,2024-01-06 13:08:00,0
5677,5678,5678,5678,2017,83,330,83,215,2017,115,83,195,188,184,83,83,330,115,31,31,2,83,7,7,7,7,6,8,2,2,2,7,7,1,2024-01-06 13:10:00,0
5683,5685,5683,5683,2010,103,337,103,207,2010,130,103,191,184,180,103,103,337,130,27,27,0,103,4,4,4,4,4,8,2,2,2,7,7,0,2024-01-06 13:12:00,0
5706,5705,5705,5705,2028,90,322,90,206,2028,116,90,207,204,201,90,90,322,116,28,28,0,90,4,4,4,4,3,6,2,2,2,3,3,1,2024-01-06 13:14:00,0
5747,5748,5748,5748,2034,90,348,90,223,2034,125,90,208,195,193,90,90,348,125,27,27,2,90,3,3,3,3,3,4,2,2,2,13,13,0,2024-01-06 13:16:00,0
5715,5715,5715,5715,2022,101,347,101,226,2022,121,101,199,190,188,101,101,347,121,32,32,0,101,8,8,8,8,8,4,2,2,2,9,9,0,2024-01-06 13:18:00,0
5732,5731,5731,5731,2023,91,353,91,217,2023,136,91,203,194,186,91,91,353,136,27,27,4,91,3,3,3,3,3,16,2,2,2,9,9,0,2024-01-06 13:20:00,0
5702,5702,5702,5702,2020,85,352,85,207,2020,145,85,201,194,191,85,85,352,145,28,28,0,85,4,4,4,4,4,6,2,2,2,7,7,0,2024-01-06 13:22:00,0
5729,5730,5730,5730,2019,94,362,94,220,2019,142,94,205,195,190,94,94,362,142,31,31,0,94,7,7,7,7,7,10,2,2,2,10,10,0,2024-01-06 13:24:00,0
5741,5741,5741,5741,2026,90,356,90,212,2026,144,90,190,185,182,90,90,356,144,28,28,0,90,4,4,4,4,3,6,2,2,2,5,5,1,2024-01-06 13:26:00,0
5710,5709,5709,5709,2033,84,330,84,215,2033,115,84,197,191,190,84,84,330,115,29,29,0,84,4,4,4,4,4,2,2,2,2,6,6,0,2024-01-06 13:28:00,0
5720,5721,5721,5721,2031,93,326,93,217,2031,109,93,210,200,200,93,93,326,109,28,28,1,93,4,4,4,4,3,0,2,2,2,10,10,1,2024-01-06 13:30:00,0
5679,5679,5679,5679,2014,88,344,88,212,2014,132,88,193,186,182,88,88,344,132,30,30,6,88,7,7,7,7,7,8,2,2,2,7,7,0,2024-01-06 13:32:00,0
5759,5758,5758,5758,2029,101,367,101,209,2029,158,101,200,194,190,101,101,367,158,28,28,0,101,4,4,4,4,4,8,2,2,2,6,6,0,2024-01-06 13:34:00,0
5714,5714,5714,5714,2031,90,342,90,211,2031,131,90,187,180,175,90,90,342,131,27,27,2,90,3,3,3,3,3,10,2,2,2,7,7,0,2024-01-06 13:36:00,0
5744,5745,5745,5745,2028,90,348,90,216,2028,132,90,200,193,185,90,90,348,132,28,28,0,90,4,4,4,4,4,16,2,2,2,7,7,0,2024-01-06 13:38:00,0
5757,5757,5757,5757,2028,101,361,101,214,2028,147,101,207,199,194,101,101,361,147,31,31,0,101,7,7,7,7,7,10,2,2,2,8,8,0,2024-01-06 13:40:00,0
5718,5717,5717,5717,2016,88,374,87,228,2016,146,87,179,173,172,87,87,374,146,28,28,4,87,4,4,4,4,3,2,2,2,2,6,6,1,2024-01-06 13:42:00,0
5745,5744,5744,5744,2032,90,370,91,219,2032,151,91,201,192,189,91,91,370,151,28,28,0,91,4,4,4,4,4,6,2,2,2,9,9,0,2024-01-06 13:44:00,0
5696,5698,5698,5698,2019,90,334,90,208,2019,126,90,197,194,191,90,90,334,126,28,28,4,90,4,4,4,4,3,6,2,2,2,3,3,1,2024-01-06 13:46:00,0
5707,5707,5707,5707,2033,104,330,104,215,2033,115,104,189,186,184,104,104,330,115,31,31,0,104,7,7,7,7,7,4,2,2,2,3,3,0,2024-01-06 13:48:00,0
5687,5687,5687,5687,2032,85,361,85,219,2032,142,85,191,186,184,85,85,361,91,29,29,0,85,5,5,4,4,4,4,2,2,2,5,5,0,2024-01-06 13:50:00,52
5722,5722,5722,5722,2025,94,349,94,218,2025,131,94,199,192,191,94,94,349,131,27,27,2,94,3,3,3,3,3,2,2,2,2,7,7,0,2024-01-06 13:52:00,0
5685,5685,5685,5685,2017,87,330,87,211,2017,119,87,199,196,196,87,87,330,119,32,32,0,87,8,8,8,8,8,0,2,2,2,3,3,0,2024-01-06 13:54:00,0
5691,5689,5689,5689,2026,91,332,91,211,2026,121,91,203,194,190,91,91,332,121,27,27,2,91,3,3,3,3,3,8,2,2,2,9,9,0,2024-01-06 13:56:00,0
5700,5701,5701,5701,2018,95,356,95,203,2018,153,95,192,182,180,95,95,356,153,28,28,0,95,4,4,4,4,3,4,2,2,2,10,10,1,2024-01-06 13:58:00,0
5667,5668,5668,5668,2012,91,318,91,210,2012,108,91,193,188,186,91,91,318,108,28,28,0,91,4,4,4,4,4,4,2,2,2,5,5,0,2024-01-06 14:00:00,0
1255,1254,1254,1254,433,13,115,13,56,433,59,13,42,42,39,13,13,115,59,8,8,0,13,3,3,3,3,3,6,1,1,1,0,0,0,2024-01-06 14:02:00,0
0,0,0,0,0,0,0,0,0,0,0,0,0,0,0,0,0,0,0,0,0,0,0,0,0,0,0,0,0,0,0,0,0,0,0,2024-01-06 14:04:00,0
982,982,982,982,352,16,42,16,42,352,0,16,41,41,41,16,16,42,0,4,4,0,16,0,0,0,0,0,0,0,0,0,0,0,0,2024-01-06 14:06:00,0
5732,5732,5732,5732,2017,102,349,102,205,2017,144,102,204,195,189,102,102,349,144,27,27,2,102,3,3,3,3,3,12,2,2,2,9,9,0,2024-01-06 14:08:00,0
5705,5706,5706,5706,2021,92,349,92,225,2021,124,92,206,198,193,92,92,349,124,32,32,0,92,8,8,8,8,8,10,2,2,2,8,8,0,2024-01-06 14:10:00,0
5729,5729,5729,5729,2023,90,344,90,213,2023,131,90,209,200,198,90,90,344,131,27,27,4,90,3,3,3,3,3,4,2,2,2,9,9,0,2024-01-06 14:12:00,0
5740,5739,5739,5739,2026,109,343,109,213,2026,130,109,203,195,193,109,109,343,130,28,28,0,109,4,4,4,4,3,4,2,2,2,8,8,1,2024-01-06 14:14:00,0
5731,5732,5732,5732,2037,96,337,96,207,2037,130,96,196,185,183,96,96,337,130,28,28,0,96,4,4,4,4,4,4,2,2,2,11,11,0,2024-01-06 14:16:00,0
5666,5667,5666,5666,2014,76,332,76,213,2014,119,76,182,175,172,76,76,332,119,31,31,4,76,7,7,7,7,6,6,2,2,2,7,7,1,2024-01-06 14:18:00,0
5736,5734,5734,5734,2020,97,346,97,214,2020,132,97,198,197,195,97,97,346,132,28,28,0,97,4,4,4,4,4,4,2,2,2,1,1,0,2024-01-06 14:20:00,0
5689,5692,5691,5691,2017,95,340,95,213,2017,127,95,200,196,194,95,95,340,127,28,28,13,95,4,4,4,4,4,4,2,2,2,4,4,0,2024-01-06 14:22:00,0
5708,5711,5708,5708,2012,84,379,84,215,2012,164,84,201,190,188,84,84,379,164,31,31,2,84,7,7,7,7,7,4,2,2,2,11,11,0,2024-01-06 14:24:00,0
5717,5717,5715,5715,2028,90,349,90,212,2028,137,90,211,198,192,90,90,349,137,28,28,0,90,4,4,4,4,4,12,2,2,2,13,13,0,2024-01-06 14:26:00,0
5734,5735,5735,5735,2026,82,362,82,205,2026,157,82,195,188,182,82,82,362,157,27,27,4,82,3,3,3,3,3,12,2,2,2,7,7,0,2024-01-06 14:28:00,0
5683,5685,5683,5683,2022,94,333,94,213,2022,120,94,195,191,187,94,94,333,120,28,28,0,94,4,4,4,4,3,8,2,2,2,4,4,1,2024-01-06 14:30:00,0
5724,5725,5725,5725,2023,102,372,102,224,2023,148,102,194,188,183,102,102,372,148,31,31,7,102,7,7,7,7,7,10,2,2,2,6,6,0,2024-01-06 14:32:00,0
5707,5706,5706,5706,2016,90,358,90,214,2016,144,90,200,191,182,90,90,358,144,28,28,17,90,4,4,4,4,3,18,2,2,2,9,9,1,2024-01-06 14:34:00,0
5724,5724,5724,5724,2027,85,361,85,217,2027,144,85,196,192,189,85,85,361,144,28,28,3,85,4,4,4,4,4,6,2,2,2,4,4,0,2024-01-06 14:36:00,0
5774,5774,5774,5774,2025,99,388,99,218,2025,170,99,188,183,182,99,99,388,170,28,28,5,99,4,4,4,4,4,2,2,2,2,5,5,0,2024-01-06 14:38:00,0
5725,5725,5725,5725,2023,87,356,87,208,2023,148,87,191,188,181,87,87,356,148,31,31,4,87,7,7,7,7,7,14,2,2,2,3,3,0,2024-01-06 14:40:00,0
5713,5714,5714,5714,2021,89,360,89,211,2021,149,89,197,192,189,89,89,360,149,28,28,0,89,4,4,4,4,4,6,2,2,2,5,5,0,2024-01-06 14:42:00,0
5678,5677,5677,5677,2023,97,338,97,208,2023,130,97,197,194,188,97,97,338,130,28,28,6,97,4,4,4,4,3,12,2,2,2,3,3,1,2024-01-06 14:44:00,0
5721,5722,5722,5722,2028,100,337,100,230,2028,107,100,193,191,185,100,100,337,107,31,31,1,100,7,7,7,7,7,12,2,2,2,2,2,0,2024-01-06 14:46:00,0
5683,5682,5682,5682,2019,95,342,95,213,2019,129,95,189,182,181,95,95,342,129,27,27,4,95,3,3,3,3,3,2,2,2,2,7,7,0,2024-01-06 14:48:00,0
5770,5770,5770,5770,2035,94,428,94,223,2035,205,94,202,196,194,94,94,428,154,29,29,14,94,5,5,4,4,3,4,2,2,2,6,6,1,2024-01-06 14:50:00,52
5169,5170,5170,5170,1950,36,287,36,159,1950,128,36,135,130,128,36,36,287,128,28,28,4,36,4,4,4,4,4,4,2,2,2,5,5,0,2024-01-06 14:52:00,0
5232,5232,5232,5232,2015,24,269,24,148,2015,121,24,130,120,118,24,24,269,121,31,31,6,24,7,7,7,7,7,4,2,2,2,10,10,0,2024-01-06 14:54:00,0
5262,5261,5261,5261,2025,24,279,24,145,2025,134,24,128,123,119,24,24,279,134,28,28,7,24,4,4,4,4,4,8,2,2,2,5,5,0,2024-01-06 14:56:00,0
5233,5234,5234,5234,2019,24,261,24,145,2019,116,24,131,122,118,24,24,261,116,28,28,18,24,4,4,4,4,4,8,2,2,2,9,9,0,2024-01-06 14:58:00,0
5266,5287,5266,5266,2021,24,299,24,148,2021,151,24,126,119,118,24,24,299,151,31,31,14,24,7,7,7,7,6,2,2,2,2,7,7,1,2024-01-06 15:00:00,0
5267,5268,5267,5267,2006,24,519,24,144,2006,375,24,135,123,118,24,24,519,375,28,28,19,24,4,4,4,4,4,10,2,2,2,12,12,0,2024-01-06 15:02:00,0
5269,5270,5269,5269,2026,24,286,24,144,2026,142,24,126,119,119,24,24,286,142,27,27,0,24,3,3,3,3,3,0,2,2,2,7,7,0,2024-01-06 15:04:00,0
5282,5281,5281,5281,2024,24,303,24,146,2024,157,24,129,120,118,24,24,303,157,28,28,6,24,4,4,4,4,3,4,2,2,2,9,9,1,2024-01-06 15:06:00,0
5269,5270,5270,5270,2023,24,294,24,149,2023,145,24,134,125,119,24,24,294,145,32,32,1,24,8,8,8,8,8,12,2,2,2,9,9,0,2024-01-06 15:08:00,0
5293,5295,5293,5293,2020,24,311,24,144,2020,167,24,136,125,118,24,24,311,167,27,27,1,24,3,3,3,3,3,14,2,2,2,11,11,0,2024-01-06 15:10:00,0
5303,5303,5303,5303,2029,24,318,24,145,2029,173,24,129,122,119,24,24,318,173,28,28,7,24,4,4,4,4,4,6,2,2,2,7,7,0,2024-01-06 15:12:00,0
5223,5222,5222,5222,2007,22,286,22,144,2007,142,22,128,120,117,22,22,286,142,28,28,3,22,4,4,4,4,4,6,2,2,2,8,8,0,2024-01-06 15:14:00,0
5308,5309,5309,5309,2035,24,313,24,149,2035,164,24,131,124,120,24,24,313,164,31,31,3,24,7,7,7,7,6,8,2,2,2,7,7,1,2024-01-06 15:16:00,0
5280,5280,5280,5280,2026,24,297,24,145,2026,152,24,130,123,118,24,24,297,152,28,28,0,24,4,4,4,4,4,10,2,2,2,7,7,0,2024-01-06 15:18:00,0
5282,5281,5281,5281,2027,24,301,24,145,2027,156,24,129,121,118,24,24,301,156,28,28,4,24,4,4,4,4,3,6,2,2,2,8,8,1,2024-01-06 15:20:00,0
5268,5269,5269,5269,2021,24,293,24,149,2021,144,24,128,123,120,24,24,293,144,31,31,12,24,7,7,7,7,7,6,2,2,2,5,5,0,2024-01-06 15:22:00,0
5284,5282,5282,5282,2021,24,312,24,144,2021,168,24,131,124,119,24,24,312,168,28,28,4,24,4,4,4,4,4,10,2,2,2,7,7,0,2024-01-06 15:24:00,0
5298,5300,5300,5300,2018,24,395,24,213,2018,182,24,134,121,118,24,24,395,182,95,95,3,24,37,3,3,3,3,6,2,2,2,13,13,0,2024-01-06 15:26:00,102
5308,5308,5308,5308,2033,24,314,24,145,2033,169,24,133,121,118,24,24,314,169,28,28,0,24,4,4,4,4,4,6,2,2,2,12,12,0,2024-01-06 15:28:00,0
5291,5291,5291,5291,2024,24,319,24,148,2024,171,24,129,120,118,24,24,319,171,31,31,10,24,7,7,7,7,7,4,2,2,2,9,9,0,2024-01-06 15:30:00,0
5263,5262,5262,5262,2018,24,297,24,145,2018,152,24,131,122,119,24,24,297,152,28,28,2,24,4,4,4,4,3,6,2,2,2,9,9,1,2024-01-06 15:32:00,0
5287,5288,5288,5288,2022,24,304,24,145,2022,159,24,136,123,120,24,24,304,159,28,28,4,24,4,4,4,4,4,6,2,2,2,13,13,0,2024-01-06 15:34:00,0
5318,5318,5318,5318,2037,24,311,24,149,2037,162,24,138,122,120,24,24,311,162,31,31,3,24,7,7,7,7,6,4,2,2,2,16,16,1,2024-01-06 15:36:00,0
5266,5266,5266,5266,2005,22,330,22,144,2005,186,22,138,123,117,22,22,330,186,28,28,8,22,4,4,4,4,4,12,2,2,2,15,15,0,2024-01-06 15:38:00,0
5303,5303,5303,5303,2025,24,316,24,145,2025,171,24,137,121,120,24,24,316,171,28,28,4,24,4,4,4,4,4,2,2,2,2,16,16,0,2024-01-06 15:40:00,0
5289,5288,5288,5288,2018,24,309,24,144,2018,165,24,141,126,118,24,24,309,165,27,27,2,24,3,3,3,3,3,16,2,2,2,15,15,0,2024-01-06 15:42:00,0
5302,5302,5302,5302,2020,24,329,24,149,2020,180,24,131,124,119,24,24,329,180,32,32,1,24,8,8,8,8,8,10,2,2,2,7,7,0,2024-01-06 15:44:00,0
5272,5272,5272,5272,2013,24,366,24,206,2013,160,24,141,121,118,24,24,366,160,89,89,2,24,3,3,3,3,3,6,2,2,2,20,20,0,2024-01-06 15:46:00,152
5263,5265,5263,5263,2016,24,322,24,168,2016,154,24,135,122,118,24,24,322,154,51,51,2,24,4,4,4,4,3,8,2,2,2,13,13,1,2024-01-06 15:48:00,46
5285,5286,5286,5286,2028,24,342,24,146,2028,196,24,138,120,118,24,24,342,145,29,29,5,24,5,5,4,4,4,4,2,2,2,18,18,0,2024-01-06 15:50:00,52
5263,5262,5262,5262,2028,24,281,24,148,2028,133,24,130,123,118,24,24,281,133,31,31,4,24,7,7,7,7,6,10,2,2,2,7,7,1,2024-01-06 15:52:00,0
5258,5258,5258,5258,2026,24,277,24,146,2026,131,24,128,122,119,24,24,277,131,28,28,0,24,4,4,4,4,4,6,2,2,2,6,6,0,2024-01-06 15:54:00,0
5306,5304,5304,5304,2037,24,299,24,145,2037,154,24,133,120,118,24,24,299,154,28,28,2,24,4,4,4,4,4,4,2,2,2,13,13,0,2024-01-06 15:56:00,0
5332,5333,5333,5333,2027,24,337,24,149,2027,188,24,143,123,119,24,24,337,188,31,31,2,24,7,7,7,7,7,8,2,2,2,20,20,0,2024-01-06 15:58:00,0
5309,5309,5309,5309,2022,24,326,24,145,2022,181,24,137,123,118,24,24,326,181,28,28,3,24,4,4,4,4,4,10,2,2,2,14,14,0,2024-01-06 16:00:00,0
5289,5291,5291,5291,1992,22,707,22,272,1992,435,22,132,121,118,22,22,707,435,156,156,8,22,68,3,3,3,3,6,2,2,2,11,11,0,2024-01-06 16:02:00,195
5290,5291,5289,5289,2020,24,387,24,218,2020,169,24,141,125,120,24,24,387,169,101,100,0,24,40,4,4,4,3,10,2,2,2,16,16,1,2024-01-06 16:04:00,110
5294,5294,5294,5294,2014,24,423,24,241,2014,182,24,136,123,118,24,24,423,182,124,125,2,24,54,7,7,7,7,10,2,2,2,13,13,0,2024-01-06 16:06:00,139
5277,5278,5278,5278,2013,24,324,24,144,2013,180,24,125,119,118,24,24,324,180,28,28,2,24,4,4,4,4,3,2,2,2,2,6,6,1,2024-01-06 16:08:00,0
5313,5313,5313,5313,2018,24,335,24,145,2018,190,24,144,125,119,24,24,335,190,28,28,5,24,4,4,4,4,4,12,2,2,2,19,19,0,2024-01-06 16:10:00,0
5314,5314,5314,5314,2027,30,333,25,148,2028,185,25,137,123,118,25,24,333,185,31,31,0,24,7,7,7,7,7,10,2,2,2,14,14,0,2024-01-06 16:12:00,2
5383,5383,5383,5383,2016,24,413,24,145,2016,268,24,141,124,118,24,24,413,268,28,28,6,24,4,4,4,4,3,12,2,2,2,17,17,1,2024-01-06 16:14:00,0
5460,5462,5460,5460,2017,24,469,24,146,2017,323,24,154,128,118,24,24,469,323,28,28,0,24,4,4,4,4,4,20,2,2,2,26,26,0,2024-01-06 16:16:00,2
5429,5430,5429,5429,2023,24,449,24,147,2023,302,24,139,125,119,24,24,449,302,30,30,4,24,5,4,4,4,3,12,2,2,2,14,14,1,2024-01-06 16:18:00,3
5457,5455,5455,5455,2017,24,465,24,148,2017,317,24,155,129,118,24,24,465,317,31,31,3,24,7,7,7,7,7,22,2,2,2,26,26,0,2024-01-06 16:20:00,0
5468,5469,5469,5469,2013,24,487,24,146,2013,341,24,151,121,119,24,24,487,341,29,29,0,24,4,4,4,4,4,4,2,2,2,30,30,0,2024-01-06 16:22:00,0
5374,5374,5372,5372,2003,23,424,23,144,2003,280,23,154,124,117,23,23,424,280,28,28,6,23,4,3,3,3,3,14,2,2,2,30,30,0,2024-01-06 16:24:00,3
5205,5208,5208,5208,2017,23,244,23,144,2017,100,23,126,123,120,23,23,244,100,28,28,8,23,4,4,4,4,4,6,2,2,2,3,3,0,2024-01-06 16:26:00,0
5233,5233,5233,5233,2030,24,245,24,148,2030,97,24,130,122,120,24,24,245,97,30,30,9,24,5,4,4,4,4,4,2,2,2,8,8,0,2024-01-06 16:28:00,3
5231,5231,5231,5231,2024,24,248,24,145,2024,103,24,132,121,118,24,24,248,103,28,28,2,24,4,4,4,4,3,6,2,2,2,11,11,1,2024-01-06 16:30:00,0
5246,5246,5246,5246,2029,24,266,24,149,2029,117,24,128,119,118,24,24,266,117,31,31,8,24,7,7,7,7,7,2,2,2,2,9,9,0,2024-01-06 16:32:00,0
5251,5251,5251,5251,2035,24,246,24,144,2035,102,24,132,120,119,24,24,246,102,27,27,8,24,3,3,3,3,3,2,2,2,2,12,12,0,2024-01-06 16:34:00,0
5226,5225,5225,5225,2018,24,257,24,145,2018,112,24,130,123,118,24,24,257,112,28,28,3,24,4,4,4,4,3,10,2,2,2,7,7,1,2024-01-06 16:36:00,0
5215,5215,5215,5215,2023,24,243,24,149,2023,94,24,131,122,119,24,24,243,94,32,32,5,24,8,8,8,8,8,6,2,2,2,9,9,0,2024-01-06 16:38:00,0
5276,5277,5277,5277,2035,24,279,24,145,2035,134,24,127,120,119,24,24,279,134,27,27,0,24,3,3,3,3,3,2,2,2,2,7,7,0,2024-01-06 16:40:00,0
5232,5231,5231,5231,2013,24,271,24,147,2013,124,24,132,121,119,24,24,271,124,30,30,9,24,5,4,4,4,4,4,2,2,2,11,11,0,2024-01-06 16:42:00,3
5256,5257,5256,5256,2023,24,282,24,145,2023,137,24,126,123,118,24,24,282,137,28,28,9,24,4,4,4,4,4,10,2,2,2,3,3,0,2024-01-06 16:44:00,0
5206,5207,5207,5207,2010,24,259,24,147,2010,112,24,133,121,118,24,24,259,112,31,31,7,24,7,7,7,7,6,6,2,2,2,12,12,1,2024-01-06 16:46:00,0
5233,5233,5233,5233,2025,24,354,24,145,2025,209,24,130,122,120,24,24,354,209,28,28,4,24,4,4,4,4,4,4,2,2,2,8,8,0,2024-01-06 16:48:00,0
5217,5236,5216,5216,2026,23,286,23,146,2026,140,23,126,121,120,23,23,286,89,28,28,1,23,4,4,3,3,3,2,2,2,2,5,5,0,2024-01-06 16:50:00,52
5240,5241,5241,5241,2026,23,360,23,151,2026,209,23,129,122,120,23,23,360,209,34,34,5,23,9,8,8,8,8,4,2,2,2,7,7,0,2024-01-06 16:52:00,3
5233,5232,5232,5232,2027,24,252,24,145,2027,107,24,128,118,118,24,24,252,107,27,27,8,24,3,3,3,3,3,0,2,2,2,10,10,0,2024-01-06 16:54:00,0
5226,5227,5227,5227,2029,24,241,24,145,2029,96,24,124,121,119,24,24,241,96,28,28,0,24,4,4,4,4,4,4,2,2,2,3,3,0,2024-01-06 16:56:00,0
5215,5215,5213,5213,2017,24,350,24,145,2017,205,24,129,119,117,24,24,350,205,28,28,0,24,4,4,4,4,4,4,2,2,2,10,10,0,2024-01-06 16:58:00,0
5276,5278,5278,5278,2029,24,284,24,148,2029,136,24,134,120,119,24,24,284,136,31,31,5,24,7,7,7,7,6,2,2,2,2,14,14,1,2024-01-06 17:00:00,0
5203,5203,5203,5203,2005,24,556,24,145,2005,411,24,132,121,117,24,24,556,411,28,28,4,24,4,4,4,4,4,8,2,2,2,11,11,0,2024-01-06 17:02:00,0
5244,5245,5243,5243,2024,24,259,24,145,2024,114,24,136,129,119,24,24,259,114,28,28,2,24,4,4,4,4,3,20,2,2,2,7,7,1,2024-01-06 17:04:00,0
5273,5274,5274,5274,2033,24,272,24,145,2033,127,24,134,121,118,24,24,272,127,27,27,0,24,3,3,3,3,3,6,2,2,2,13,13,0,2024-01-06 17:06:00,0
5244,5243,5243,5243,2021,24,273,24,151,2021,122,24,129,121,119,24,24,273,122,34,34,2,24,9,8,8,8,8,4,2,2,2,8,8,0,2024-01-06 17:08:00,3
5185,5186,5186,5186,2002,24,260,24,143,2002,117,24,126,119,117,24,24,260,117,27,27,0,24,3,3,3,3,3,4,2,2,2,7,7,0,2024-01-06 17:10:00,0
5236,5236,5236,5236,2034,24,237,24,146,2034,91,24,129,121,119,24,24,237,91,28,28,4,24,4,4,4,4,4,4,2,2,2,8,8,0,2024-01-06 17:12:00,0
5240,5260,5239,5239,2019,23,275,23,148,2019,127,23,125,120,118,23,23,275,127,31,31,5,23,7,7,7,7,7,4,2,2,2,5,5,0,2024-01-06 17:14:00,0
5231,5231,5230,5230,2023,24,252,24,145,2023,107,24,134,122,119,24,24,252,107,28,28,0,24,4,4,4,4,3,6,2,2,2,12,12,1,2024-01-06 17:16:00,0
5235,5236,5236,5236,2023,23,267,23,147,2023,120,23,128,119,117,23,23,267,120,30,30,14,23,5,4,4,4,4,4,2,2,2,9,9,0,2024-01-06 17:18:00,3
5259,5259,5259,5259,2020,24,281,24,149,2020,132,24,138,126,119,24,24,281,132,32,32,4,24,6,4,4,4,3,14,2,2,2,12,12,1,2024-01-06 17:20:00,6
5260,5261,5261,5261,2031,24,272,24,148,2031,124,24,132,119,118,24,24,272,124,31,31,2,24,7,7,7,7,7,2,2,2,2,13,13,0,2024-01-06 17:22:00,0
5252,5254,5252,5252,2033,24,250,24,146,2033,104,24,132,121,119,24,24,250,104,28,28,2,24,4,4,4,4,4,4,2,2,2,11,11,0,2024-01-06 17:24:00,0
5265,5265,5264,5264,2038,24,255,24,145,2038,110,24,132,124,120,24,24,255,110,27,27,4,24,3,3,3,3,3,8,2,2,2,8,8,0,2024-01-06 17:26:00,0
5243,5245,5244,5244,2023,24,260,24,145,2023,115,24,135,121,118,24,24,260,115,28,28,4,24,4,4,4,4,4,6,2,2,2,14,14,0,2024-01-06 17:28:00,0
5249,5248,5248,5248,2029,24,273,24,149,2029,124,24,123,118,118,24,24,273,124,31,31,5,24,7,7,7,7,7,0,2,2,2,5,5,0,2024-01-06 17:30:00,0
5281,5282,5282,5282,2025,24,296,24,145,2025,151,24,134,123,121,24,24,296,151,28,28,1,24,4,4,4,4,3,4,2,2,2,11,11,1,2024-01-06 17:32:00,0
5189,5189,5189,5189,2006,24,255,24,144,2006,111,24,131,120,117,24,24,255,111,28,28,1,24,4,4,4,4,4,6,2,2,2,11,11,0,2024-01-06 17:34:00,0
5234,5233,5233,5233,2032,24,243,24,149,2032,94,24,128,120,119,24,24,243,94,31,31,4,24,7,7,7,7,6,2,2,2,2,8,8,1,2024-01-06 17:36:00,0
5245,5246,5246,5246,2019,24,271,24,147,2019,124,24,134,122,119,24,24,271,124,30,30,0,24,5,4,4,4,4,6,2,2,2,12,12,0,2024-01-06 17:38:00,3
5297,5296,5296,5296,2027,24,304,24,145,2027,159,24,137,121,118,24,23,304,159,28,28,4,24,4,4,4,4,4,6,2,2,2,16,16,0,2024-01-06 17:40:00,0
5243,5242,5242,5242,2011,23,291,23,144,2011,147,23,133,122,118,23,24,291,147,27,27,0,23,3,3,3,3,3,8,2,2,2,11,11,0,2024-01-06 17:42:00,0
5228,5231,5230,5230,2016,24,270,24,148,2016,122,24,126,118,118,24,24,270,122,32,32,0,24,8,8,8,8,8,0,2,2,2,8,8,0,2024-01-06 17:44:00,0
5261,5261,5261,5261,2035,23,265,23,145,2035,120,23,129,119,119,23,23,265,120,27,27,7,23,3,3,3,3,3,0,2,2,2,10,10,0,2024-01-06 17:46:00,0
5238,5237,5237,5237,2026,24,257,24,145,2026,112,24,127,119,118,24,24,257,112,28,28,2,24,4,4,4,4,3,2,2,2,2,8,8,1,2024-01-06 17:48:00,0
5255,5257,5256,5256,2027,24,268,24,150,2027,118,24,137,124,120,24,24,268,118,32,32,1,24,8,8,8,8,8,8,2,2,2,13,13,0,2024-01-06 17:50:00,0
5236,5236,5236,5236,2019,24,271,24,143,2019,128,24,128,121,118,24,24,271,128,27,27,3,24,3,3,3,3,3,6,2,2,2,7,7,0,2024-01-06 17:52:00,0
5230,5229,5229,5229,2027,24,249,24,146,2027,103,24,126,122,118,24,24,249,103,28,28,0,24,4,4,4,4,3,8,2,2,2,4,4,1,2024-01-06 17:54:00,0
5224,5228,5224,5224,2022,24,248,24,145,2022,103,24,131,122,119,24,24,248,103,28,28,0,24,4,4,4,4,4,6,2,2,2,9,9,0,2024-01-06 17:56:00,0
5185,5186,5186,5186,1994,24,281,24,146,1994,135,24,131,120,117,24,24,281,135,31,31,4,24,7,7,7,7,6,6,2,2,2,11,11,1,2024-01-06 17:58:00,0
5231,5300,5228,5228,2013,24,278,24,145,2013,133,24,129,122,118,24,24,278,133,28,28,3,24,4,4,4,4,4,8,2,2,2,7,7,0,2024-01-06 18:00:00,0
5145,5148,5148,5148,1984,23,541,23,145,1984,396,23,127,119,118,23,23,541,396,28,28,0,23,4,4,4,4,4,2,2,2,2,8,8,0,2024-01-06 18:02:00,0
5253,5271,5252,5252,2025,24,278,24,145,2025,133,24,129,121,118,24,24,278,133,28,28,3,24,4,4,4,4,3,6,2,2,2,8,8,1,2024-01-06 18:04:00,0
5261,5263,5262,5262,2027,24,285,24,149,2027,136,24,127,122,118,24,24,285,136,31,31,5,24,7,7,7,7,7,8,2,2,2,5,5,0,2024-01-06 18:06:00,0
5246,5248,5246,5246,2023,23,262,23,144,2023,118,23,135,121,119,23,23,262,118,27,27,0,23,3,3,3,3,3,4,2,2,2,14,14,0,2024-01-06 18:08:00,0
5221,5220,5220,5220,2016,24,256,24,144,2016,112,24,133,121,117,24,24,256,112,28,28,0,24,4,4,4,4,3,8,2,2,2,12,12,1,2024-01-06 18:10:00,0
5212,5213,5213,5213,2021,24,238,24,146,2021,92,24,130,122,118,24,24,238,92,28,28,8,24,4,4,4,4,4,8,2,2,2,8,8,0,2024-01-06 18:12:00,0
5239,5239,5239,5239,2028,24,262,24,148,2028,114,24,125,119,119,24,24,262,114,31,31,0,24,7,7,7,7,7,0,2,2,2,6,6,0,2024-01-06 18:14:00,0
5236,5236,5236,5236,2026,24,256,24,145,2026,111,24,128,122,118,24,24,256,111,28,28,4,24,4,4,4,4,4,8,2,2,2,6,6,0,2024-01-06 18:16:00,0
5237,5236,5236,5236,2021,24,263,24,145,2021,118,24,131,122,118,24,24,263,118,28,28,0,24,4,4,4,4,4,8,2,2,2,9,9,0,2024-01-06 18:18:00,0
5167,5167,5167,5167,1998,24,246,24,144,1998,102,24,126,121,117,24,24,246,102,28,28,0,24,4,4,4,4,3,8,2,2,2,5,5,1,2024-01-06 18:20:00,0
5227,5227,5227,5227,2012,24,263,24,148,2012,115,24,139,123,119,24,24,263,115,31,31,4,24,7,7,7,7,7,8,2,2,2,16,16,0,2024-01-06 18:22:00,0
5228,5228,5228,5228,2021,24,255,24,144,2021,111,24,127,119,118,24,24,255,111,27,27,0,24,3,3,3,3,3,2,2,2,2,8,8,0,2024-01-06 18:24:00,0
5222,5221,5221,5221,2020,23,250,23,145,2020,105,23,131,122,119,23,23,250,105,28,28,5,23,4,4,4,4,3,6,2,2,2,9,9,1,2024-01-06 18:26:00,0
5252,5254,5253,5253,2033,24,258,24,145,2033,113,24,128,120,118,24,24,258,113,28,28,0,24,4,4,4,4,4,4,2,2,2,8,8,0,2024-01-06 18:28:00,0
5229,5229,5229,5229,2021,24,258,24,148,2021,110,24,132,119,119,24,24,258,110,31,31,8,24,7,7,7,7,7,0,2,2,2,13,13,0,2024-01-06 18:30:00,0
5214,5215,5215,5215,2031,24,222,24,146,2031,76,24,131,122,120,24,24,222,76,28,28,2,24,4,4,4,4,4,4,2,2,2,9,9,0,2024-01-06 18:32:00,0
5208,5209,5207,5207,2027,23,231,23,145,2027,86,23,126,120,118,23,23,231,86,28,28,11,23,4,4,4,4,4,4,2,2,2,6,6,0,2024-01-06 18:34:00,0
5232,5232,5232,5232,2033,24,241,24,148,2033,93,24,130,123,119,24,24,241,93,31,31,0,24,7,7,7,7,6,8,2,2,2,7,7,1,2024-01-06 18:36:00,0
5241,5242,5242,5242,2029,24,252,24,146,2029,106,24,129,123,118,24,24,252,106,28,28,4,24,4,4,4,4,4,10,2,2,2,6,6,0,2024-01-06 18:38:00,0
5225,5225,5225,5225,2017,24,243,24,144,2017,99,24,139,122,119,24,24,243,99,27,27,0,24,3,3,3,3,3,6,2,2,2,17,17,0,2024-01-06 18:40:00,0
5267,5266,5266,5266,2020,24,294,24,145,2020,149,24,139,126,118,24,24,294,149,28,28,0,24,4,4,4,4,3,16,2,2,2,13,13,1,2024-01-06 18:42:00,0
5240,5239,5239,5239,2016,24,285,24,148,2016,137,24,130,119,117,24,24,285,137,31,31,0,24,8,8,8,8,8,4,2,2,2,11,11,0,2024-01-06 18:44:00,0
5233,5234,5234,5234,2018,24,266,24,143,2018,123,24,127,118,118,24,24,266,123,27,27,0,24,3,3,3,3,3,0,2,2,2,9,9,0,2024-01-06 18:46:00,0
5294,5295,5295,5295,2037,24,288,24,146,2037,142,24,135,122,119,24,24,288,142,28,28,5,24,4,4,4,4,4,6,2,2,2,13,13,0,2024-01-06 18:48:00,0
5272,5270,5270,5270,2034,24,271,24,146,2034,125,24,131,121,120,24,24,271,125,28,28,0,24,4,4,4,4,4,2,2,2,2,10,10,0,2024-01-06 18:50:00,0
5261,5262,5262,5262,2026,24,282,24,149,2026,133,24,128,121,118,24,24,282,133,32,32,2,24,8,8,8,8,8,6,2,2,2,7,7,0,2024-01-06 18:52:00,0
5230,5271,5230,5230,2022,23,253,23,144,2022,109,23,133,122,119,23,23,253,109,27,27,0,23,3,3,3,3,3,6,2,2,2,11,11,0,2024-01-06 18:54:00,0
5223,5224,5224,5224,2019,24,252,24,145,2019,107,24,129,120,118,24,24,252,107,28,28,0,24,4,4,4,4,4,4,2,2,2,9,9,0,2024-01-06 18:56:00,0
5248,5248,5248,5248,2021,24,271,24,145,2021,126,24,133,122,118,24,24,271,126,28,28,2,24,4,4,4,4,4,8,2,2,2,11,11,0,2024-01-06 18:58:00,0
5237,5237,5236,5236,2017,23,274,23,148,2017,126,23,124,120,118,23,23,274,126,31,31,0,23,7,7,7,7,6,4,2,2,2,4,4,1,2024-01-06 19:00:00,0
5203,5201,5203,5203,2008,24,445,24,145,2008,300,24,136,123,118,24,24,445,300,28,28,2,24,4,4,4,4,4,10,2,2,2,13,13,0,2024-01-06 19:02:00,0
5231,5232,5232,5232,2017,24,263,24,145,2017,118,24,133,123,118,24,24,263,118,27,27,3,24,3,3,3,3,3,10,2,2,2,10,10,0,2024-01-06 19:04:00,2
5244,5243,5243,5243,2023,24,268,24,151,2023,117,24,133,123,118,24,24,268,117,34,34,0,24,7,4,4,4,3,10,2,2,2,10,10,1,2024-01-06 19:06:00,9
5196,5197,5197,5197,2004,24,337,24,221,2004,116,24,135,124,118,24,24,337,116,105,105,2,24,45,8,8,8,8,12,2,2,2,11,11,0,2024-01-06 19:08:00,109
5231,5231,5231,5231,2028,24,301,24,198,2028,103,24,128,123,119,24,24,301,103,81,81,0,24,30,3,3,3,3,8,2,2,2,5,5,0,2024-01-06 19:10:00,81
5230,5250,5229,5229,2024,24,247,24,146,2024,101,24,128,121,118,24,24,247,101,28,28,0,24,4,4,4,4,4,6,2,2,2,7,7,0,2024-01-06 19:12:00,0
5254,5254,5254,5254,2033,24,336,24,217,2033,119,24,128,122,118,24,24,336,119,100,100,0,24,40,4,4,4,4,8,2,2,2,6,6,0,2024-01-06 19:14:00,108
5211,5212,5212,5212,2016,24,249,24,148,2016,101,24,127,121,118,24,24,249,101,31,31,1,24,7,7,7,7,6,6,2,2,2,6,6,1,2024-01-06 19:16:00,0
5244,5264,5244,5244,2024,23,262,23,145,2024,117,23,133,121,118,23,23,262,117,28,28,4,23,4,4,4,4,4,6,2,2,2,12,12,0,2024-01-06 19:18:00,0
5242,5241,5241,5241,2015,24,281,24,145,2015,136,24,124,120,119,24,24,281,136,28,28,0,24,4,4,4,4,3,2,2,2,2,4,4,1,2024-01-06 19:20:00,0
5207,5207,5207,5207,2015,24,350,24,148,2015,202,24,128,123,119,24,24,350,202,31,31,0,24,7,7,7,7,7,8,2,2,2,5,5,0,2024-01-06 19:22:00,0
5246,5246,5246,5246,2027,23,259,23,145,2027,114,23,138,124,119,23,23,259,114,28,28,2,23,4,4,4,4,4,10,2,2,2,14,14,0,2024-01-06 19:24:00,0
5228,5229,5229,5229,2019,24,250,24,144,2019,106,24,132,122,118,24,24,250,106,27,27,0,24,3,3,3,3,3,8,2,2,2,10,10,0,2024-01-06 19:26:00,0
5246,5245,5245,5245,2029,24,258,24,145,2029,113,24,130,121,119,24,24,258,113,28,28,3,24,4,4,4,4,4,4,2,2,2,9,9,0,2024-01-06 19:28:00,0
5231,5232,5232,5232,2025,24,391,24,283,2025,108,24,127,119,118,24,24,391,108,165,165,1,24,74,7,7,7,7,2,2,2,2,8,8,0,2024-01-06 19:30:00,201
5214,5214,5214,5214,2018,24,272,24,150,2018,122,24,126,120,117,24,24,272,122,34,34,0,24,7,4,4,4,3,6,2,2,2,6,6,1,2024-01-06 19:32:00,9
5239,5238,5238,5238,2016,24,267,24,145,2016,122,24,135,124,119,24,24,267,122,28,28,4,24,4,4,4,4,4,10,2,2,2,11,11,0,2024-01-06 19:34:00,0
5214,5215,5215,5215,2023,24,240,24,145,2023,95,24,128,122,119,24,24,240,95,28,28,0,24,4,4,4,4,3,6,2,2,2,6,6,1,2024-01-06 19:36:00,0
5259,5259,5259,5259,2037,24,256,24,149,2037,107,24,132,124,120,24,24,256,107,31,31,0,24,7,7,7,7,7,8,2,2,2,8,8,0,2024-01-06 19:38:00,0
5260,5258,5258,5258,2030,24,314,24,193,2030,121,24,132,121,118,24,24,314,121,75,75,4,24,27,4,4,4,4,6,2,2,2,11,11,0,2024-01-06 19:40:00,71
5252,5254,5254,5254,2016,24,335,24,196,2016,139,24,131,123,119,24,24,335,139,79,79,0,24,29,3,3,3,3,8,2,2,2,8,8,0,2024-01-06 19:42:00,78
5277,5276,5276,5276,2035,23,454,23,328,2035,126,23,136,124,119,23,23,454,126,210,210,0,23,95,4,4,4,4,10,2,2,2,12,12,0,2024-01-06 19:44:00,273
5257,5257,5257,5257,2020,24,288,24,148,2020,140,24,129,121,118,24,24,288,140,31,31,0,24,7,7,7,7,7,6,2,2,2,8,8,0,2024-01-06 19:46:00,0
5212,5232,5213,5213,2018,24,245,24,145,2018,100,24,129,120,118,24,24,245,100,28,28,1,24,4,4,4,4,3,4,2,2,2,9,9,1,2024-01-06 19:48:00,0
5271,5270,5270,5270,2042,23,255,23,146,2042,109,23,130,121,119,23,23,255,109,28,28,4,23,4,4,4,4,4,4,2,2,2,9,9,0,2024-01-06 19:50:00,0
5256,5256,5256,5256,2026,24,372,24,145,2026,227,24,132,122,118,24,24,372,227,28,28,0,24,4,4,4,4,4,8,2,2,2,10,10,0,2024-01-06 19:52:00,0
5237,5237,5238,5238,2022,24,264,24,148,2022,116,24,133,123,118,24,24,264,116,31,31,2,24,7,7,7,7,7,10,2,2,2,10,10,0,2024-01-06 19:54:00,0
5178,5179,5178,5178,2002,24,250,24,144,2002,106,24,125,119,117,24,24,250,106,28,28,0,24,4,4,4,4,4,4,2,2,2,6,6,0,2024-01-06 19:56:00,0
5256,5255,5255,5255,2022,24,380,24,145,2022,235,24,129,124,119,24,24,380,235,28,28,0,24,4,4,4,4,4,10,2,2,2,5,5,0,2024-01-06 19:58:00,0
5263,5264,5264,5264,2025,24,277,24,145,2025,132,24,132,125,119,24,24,277,132,28,28,4,24,4,4,4,4,3,12,2,2,2,7,7,1,2024-01-06 20:00:00,0
5228,5227,5228,5228,2011,24,378,24,148,2011,230,24,130,122,119,24,24,378,230,31,31,0,24,7,7,7,7,7,6,2,2,2,8,8,0,2024-01-06 20:02:00,0
5252,5252,5252,5252,2026,24,266,24,144,2026,122,24,131,122,118,24,24,266,122,27,27,3,24,3,3,3,3,3,8,2,2,2,9,9,0,2024-01-06 20:04:00,0
5251,5251,5251,5251,2027,24,263,24,145,2027,118,24,133,120,118,24,24,263,118,28,28,1,24,4,4,4,4,3,4,2,2,2,13,13,1,2024-01-06 20:06:00,0
5262,5260,5260,5260,2029,24,272,24,149,2029,123,24,129,124,119,24,24,272,123,31,31,0,24,7,7,7,7,7,10,2,2,2,5,5,0,2024-01-06 20:08:00,0
5259,5260,5260,5260,2019,23,280,23,144,2019,136,23,138,122,118,23,23,280,136,28,28,4,23,4,4,4,4,4,8,2,2,2,16,16,0,2024-01-06 20:10:00,0
5220,5220,5220,5220,2019,24,258,24,145,2019,113,24,126,122,118,24,24,258,113,28,28,0,24,4,4,4,4,4,8,2,2,2,4,4,0,2024-01-06 20:12:00,0
5253,5252,5252,5252,2027,24,262,24,146,2027,116,24,131,119,119,24,24,262,116,28,28,0,24,4,4,4,4,4,0,2,2,2,12,12,0,2024-01-06 20:14:00,0
5243,5245,5245,5245,2033,23,257,23,148,2033,109,23,126,120,118,23,23,257,109,31,31,4,23,7,7,7,7,6,4,2,2,2,6,6,1,2024-01-06 20:16:00,0
5196,5196,5196,5196,2015,24,238,24,145,2015,93,24,130,120,118,24,24,238,93,28,28,0,24,4,4,4,4,4,4,2,2,2,10,10,0,2024-01-06 20:18:00,0
5233,5233,5233,5233,2024,24,251,24,144,2024,107,24,132,121,118,24,24,251,107,27,27,4,24,3,3,3,3,3,6,2,2,2,11,11,0,2024-01-06 20:20:00,0
5198,5199,5198,5198,2007,24,359,24,145,2007,214,24,126,119,118,24,24,359,214,28,28,0,24,4,4,4,4,3,2,2,2,2,7,7,1,2024-01-06 20:22:00,0
5254,5254,5254,5254,2025,24,267,24,149,2025,118,24,135,123,118,24,24,267,118,32,32,0,24,8,8,8,8,8,10,2,2,2,12,12,0,2024-01-06 20:24:00,0
5236,5236,5236,5236,2029,24,249,24,144,2029,105,24,128,120,118,24,24,249,105,27,27,4,24,3,3,3,3,3,4,2,2,2,8,8,0,2024-01-06 20:26:00,0
5245,5244,5244,5244,2029,24,256,24,146,2029,110,24,130,121,118,24,24,256,110,28,28,0,24,4,4,4,4,4,6,2,2,2,9,9,0,2024-01-06 20:28:00,0
5252,5253,5253,5253,2032,24,252,24,145,2032,107,24,134,122,119,24,24,252,107,28,28,2,24,4,4,4,4,4,6,2,2,2,12,12,0,2024-01-06 20:30:00,0
5219,5219,5219,5219,2014,24,259,24,148,2014,111,24,132,121,118,24,24,259,111,31,31,0,24,7,7,7,7,6,6,2,2,2,11,11,1,2024-01-06 20:32:00,0
5249,5248,5248,5248,2022,23,268,23,145,2022,123,23,135,122,118,23,23,268,123,28,28,0,23,4,4,4,4,4,8,2,2,2,13,13,0,2024-01-06 20:34:00,0
5248,5271,5249,5249,2022,24,267,24,145,2022,122,24,134,123,119,24,24,267,122,28,28,4,24,4,4,4,4,3,8,2,2,2,11,11,1,2024-01-06 20:36:00,0
5236,5236,5236,5236,2021,24,263,24,144,2021,119,24,127,122,118,24,24,263,119,27,27,0,24,3,3,3,3,3,8,2,2,2,5,5,0,2024-01-06 20:38:00,0
5236,5236,5236,5236,2028,24,253,24,150,2028,103,24,126,120,118,24,24,253,103,32,32,0,24,8,8,8,8,8,4,2,2,2,6,6,0,2024-01-06 20:40:00,0
5211,5211,5211,5211,2006,23,379,23,143,2006,236,23,128,125,119,23,23,379,236,27,27,2,23,3,3,3,3,3,12,2,2,2,3,3,0,2024-01-06 20:42:00,0
5294,5294,5294,5294,2035,24,293,24,146,2035,147,24,131,123,120,24,24,293,147,28,28,0,24,4,4,4,4,4,6,2,2,2,8,8,0,2024-01-06 20:44:00,0
5253,5252,5252,5252,2030,24,260,24,145,2030,115,24,132,120,118,24,24,260,115,28,28,4,24,4,4,4,4,4,4,2,2,2,12,12,0,2024-01-06 20:46:00,0
5264,5265,5265,5265,2030,24,274,24,149,2030,125,24,130,120,118,24,24,274,125,31,31,0,24,7,7,7,7,6,4,2,2,2,10,10,1,2024-01-06 20:48:00,0
5233,5232,5232,5232,2028,24,245,24,145,2028,100,24,130,121,119,24,24,245,100,28,28,0,24,4,4,4,4,4,4,2,2,2,9,9,0,2024-01-06 20:50:00,0
5295,5296,5296,5296,2024,24,310,24,145,2024,165,24,136,121,118,24,24,310,165,28,28,2,24,4,4,4,4,4,6,2,2,2,15,15,0,2024-01-06 20:52:00,0
5206,5206,5206,5206,2015,24,249,24,148,2015,101,24,126,120,119,24,24,249,101,31,31,0,24,7,7,7,7,7,2,2,2,2,6,6,0,2024-01-06 20:54:00,0
5265,5264,5264,5264,2037,24,260,24,146,2037,114,24,130,121,118,24,24,260,114,28,28,0,24,4,4,4,4,4,6,2,2,2,9,9,0,2024-01-06 20:56:00,0
5260,5261,5261,5261,2036,24,259,24,145,2036,114,24,132,120,120,24,24,259,114,28,28,0,24,4,4,4,4,4,0,2,2,2,12,12,0,2024-01-06 20:58:00,0
5261,5261,5261,5261,2029,23,267,23,146,2029,121,23,137,121,119,23,23,267,121,28,28,0,23,4,4,4,4,3,4,2,2,2,16,16,1,2024-01-06 21:00:00,0
5248,5247,5247,5247,2013,24,688,24,148,2013,540,24,132,124,118,24,24,688,540,31,31,5,24,7,7,7,7,7,12,2,2,2,8,8,0,2024-01-06 21:02:00,0
5218,5219,5219,5219,2015,24,270,24,143,2015,127,24,126,119,118,24,24,270,127,27,27,0,24,3,3,3,3,3,2,2,2,2,7,7,0,2024-01-06 21:04:00,0
5242,5241,5241,5241,2019,24,270,24,145,2019,125,24,134,120,117,24,24,270,125,28,28,0,24,4,4,4,4,3,6,2,2,2,14,14,1,2024-01-06 21:06:00,0
5251,5250,5250,5250,2028,23,261,23,145,2028,116,23,130,120,119,23,23,261,116,28,28,4,23,4,4,4,4,4,2,2,2,2,10,10,0,2024-01-06 21:08:00,0
5252,5254,5254,5254,2031,24,262,24,149,2031,113,24,131,121,118,24,24,262,113,31,31,0,24,7,7,7,7,7,6,2,2,2,10,10,0,2024-01-06 21:10:00,0
5276,5275,5275,5275,2026,24,286,24,145,2026,141,24,133,121,118,24,24,286,141,28,28,2,24,4,4,4,4,4,6,2,2,2,12,12,0,2024-01-06 21:12:00,0
5226,5226,5226,5226,2022,24,256,24,145,2022,111,24,124,121,118,24,24,256,111,28,28,0,24,4,4,4,4,4,6,2,2,2,3,3,0,2024-01-06 21:14:00,0
5223,5223,5223,5223,2020,24,246,24,145,2020,101,24,132,123,120,24,24,246,101,28,28,1,24,4,4,4,4,3,6,2,2,2,9,9,1,2024-01-06 21:16:00,0
5251,5251,5251,5251,2028,24,367,24,149,2028,218,24,131,122,118,24,24,367,218,31,31,4,24,7,7,7,7,7,8,2,2,2,9,9,0,2024-01-06 21:18:00,0
5228,5229,5228,5228,2025,24,248,24,144,2025,104,24,129,120,119,24,24,248,104,27,27,0,24,3,3,3,3,3,2,2,2,2,9,9,0,2024-01-06 21:20:00,0
5208,5206,5206,5206,2010,24,254,24,144,2010,110,24,130,122,118,24,24,254,110,28,28,4,24,4,4,4,4,3,8,2,2,2,8,8,1,2024-01-06 21:22:00,0
5214,5215,5215,5215,2020,23,250,23,149,2020,101,23,124,119,118,23,23,250,101,32,32,0,23,8,8,8,8,8,2,2,2,2,5,5,0,2024-01-06 21:24:00,0
5227,5229,5229,5229,2014,24,268,24,144,2014,124,24,129,120,118,24,24,268,124,27,27,0,24,3,3,3,3,3,4,2,2,2,9,9,0,2024-01-06 21:26:00,0
5164,5164,5164,5164,2004,24,237,24,143,2004,94,24,123,117,117,24,24,237,94,27,27,2,24,4,4,4,4,4,0,2,2,2,6,6,0,2024-01-06 21:28:00,0
5224,5224,5224,5224,2023,24,247,24,145,2023,102,24,128,119,119,24,24,247,102,28,28,0,24,4,4,4,4,4,0,2,2,2,9,9,0,2024-01-06 21:30:00,0
5252,5253,5252,5252,2022,23,273,23,148,2022,125,23,132,121,119,23,23,273,125,31,31,0,23,7,7,7,7,6,4,2,2,2,11,11,1,2024-01-06 21:32:00,0
5250,5249,5249,5249,2025,24,265,24,145,2025,120,24,130,122,118,24,24,265,120,28,28,0,24,4,4,4,4,4,8,2,2,2,8,8,0,2024-01-06 21:34:00,0
5238,5238,5238,5238,2029,24,253,24,145,2029,108,24,122,119,118,24,24,253,108,27,27,1,24,3,3,3,3,3,2,2,2,2,3,3,0,2024-01-06 21:36:00,0
5282,5282,5282,5282,2042,24,374,24,146,2042,228,24,128,121,119,24,24,374,228,28,28,0,24,4,4,4,4,3,4,2,2,2,7,7,1,2024-01-06 21:38:00,0
5245,5245,5245,5245,2037,24,253,24,151,2037,102,24,124,121,118,24,24,253,102,33,33,0,24,8,8,8,8,8,6,2,2,2,3,3,0,2024-01-06 21:40:00,0
5249,5249,5249,5249,2022,24,370,24,144,2022,226,24,129,121,119,24,24,370,226,27,27,1,24,3,3,3,3,3,4,2,2,2,8,8,0,2024-01-06 21:42:00,0
5244,5245,5245,5245,2024,24,271,24,145,2024,126,24,129,122,118,24,24,271,126,28,28,1,24,4,4,4,4,4,8,2,2,2,7,7,0,2024-01-06 21:44:00,0
5258,5258,5258,5258,2027,24,271,24,145,2027,126,24,128,120,118,24,24,271,126,28,28,0,24,4,4,4,4,4,4,2,2,2,8,8,0,2024-01-06 21:46:00,0
5221,5221,5221,5221,2018,24,249,24,148,2018,101,24,133,120,118,24,24,249,101,31,31,4,24,7,7,7,7,6,4,2,2,2,13,13,1,2024-01-06 21:48:00,0
5240,5240,5240,5240,2023,24,260,24,145,2023,115,24,129,120,119,24,24,260,115,28,28,2,24,4,4,4,4,4,2,2,2,2,9,9,0,2024-01-06 21:50:00,0
5215,5215,5215,5215,2015,23,264,23,144,2015,120,23,128,121,118,23,23,264,120,27,27,0,23,4,4,4,4,4,6,2,2,2,7,7,0,2024-01-06 21:52:00,0
5232,5232,5232,5232,2017,24,263,24,145,2017,118,24,130,122,118,24,24,263,118,28,28,4,24,4,4,4,4,4,8,2,2,2,8,8,0,2024-01-06 21:54:00,0
5208,5208,5208,5208,2019,24,267,24,147,2019,120,24,132,120,119,24,24,267,120,31,31,0,24,7,7,7,7,7,2,2,2,2,12,12,0,2024-01-06 21:56:00,1
5121,5121,5121,5121,2020,23,264,23,145,2020,119,23,132,122,118,23,23,264,119,28,28,2,23,4,4,4,4,4,8,2,2,2,10,10,0,2024-01-06 21:58:00,0
5139,5139,5139,5139,2028,24,267,24,146,2028,121,24,135,121,119,24,24,267,121,28,28,0,24,4,4,4,4,3,4,2,2,2,14,14,1,2024-01-06 22:00:00,0
5108,5130,5108,5108,2009,24,573,24,148,2009,425,24,132,120,117,24,24,573,425,31,31,0,24,7,7,7,7,7,6,2,2,2,12,12,0,2024-01-06 22:02:00,0
5146,5146,5146,5146,2039,24,355,24,144,2039,211,24,129,123,120,24,24,355,211,27,27,4,24,3,3,3,3,3,6,2,2,2,6,6,0,2024-01-06 22:04:00,0
5116,5114,5114,5114,2019,24,258,24,145,2019,113,24,136,123,118,24,24,258,113,28,28,0,24,4,4,4,4,3,10,2,2,2,13,13,1,2024-01-06 22:06:00,0
5111,5113,5113,5113,2025,24,249,24,146,2025,103,24,129,121,118,24,24,249,103,28,28,4,24,4,4,4,4,4,6,2,2,2,8,8,0,2024-01-06 22:08:00,0
5136,5137,5136,5136,2034,24,251,24,148,2034,103,24,137,128,119,24,24,251,103,31,31,0,24,7,7,7,7,7,18,2,2,2,9,9,0,2024-01-06 22:10:00,0
5134,5133,5133,5133,2035,24,357,24,146,2035,211,24,125,121,118,24,24,357,211,28,28,0,24,4,4,4,4,4,6,2,2,2,4,4,0,2024-01-06 22:12:00,0
5110,5109,5109,5109,2019,23,269,23,145,2019,124,23,128,120,118,23,23,269,124,28,28,2,23,4,4,4,4,4,4,2,2,2,8,8,0,2024-01-06 22:14:00,0
5119,5121,5121,5121,2022,24,260,24,145,2022,115,24,129,121,119,24,24,260,115,28,28,0,24,4,4,4,4,3,4,2,2,2,8,8,1,2024-01-06 22:16:00,0
5136,5135,5135,5135,2035,24,257,24,149,2035,108,24,131,124,119,24,24,257,108,31,31,0,24,7,7,7,7,7,10,2,2,2,7,7,0,2024-01-06 22:18:00,0
5138,5139,5139,5139,2034,24,261,24,145,2034,116,24,127,119,118,24,24,261,116,27,27,2,24,3,3,3,3,3,2,2,2,2,8,8,0,2024-01-06 22:20:00,0
5089,5089,5089,5089,2019,24,340,24,145,2019,195,24,131,122,119,24,24,340,195,28,28,0,24,4,4,4,4,3,6,2,2,2,9,9,1,2024-01-06 22:22:00,0
5119,5118,5118,5118,2028,24,250,24,145,2028,105,24,130,121,119,24,24,250,105,28,28,4,24,4,4,4,4,4,4,2,2,2,9,9,0,2024-01-06 22:24:00,0
5119,5139,5120,5120,2029,23,256,23,148,2029,108,23,127,118,118,23,23,256,108,31,31,0,23,7,7,7,7,7,0,2,2,2,9,9,0,2024-01-06 22:26:00,0
5134,5133,5133,5133,2026,24,266,24,146,2026,120,24,129,125,119,24,24,266,120,28,28,0,24,4,4,4,4,4,12,2,2,2,4,4,0,2024-01-06 22:28:00,0
5104,5105,5105,5105,2023,24,241,24,145,2023,96,24,133,122,118,24,24,241,96,28,28,4,24,4,4,4,4,4,8,2,2,2,11,11,0,2024-01-06 22:30:00,0
5129,5129,5129,5129,2035,24,247,24,145,2035,102,24,132,122,119,24,24,247,102,28,28,0,24,4,4,4,4,3,6,2,2,2,10,10,1,2024-01-06 22:32:00,0
5168,5168,5168,5168,2031,24,288,24,149,2031,139,24,138,121,118,24,24,288,139,31,31,2,24,7,7,7,7,7,6,2,2,2,17,17,0,2024-01-06 22:34:00,0
5111,5111,5111,5111,2019,24,267,24,144,2019,123,24,132,125,118,24,24,267,123,27,27,2,24,3,3,3,3,3,14,2,2,2,7,7,0,2024-01-06 22:36:00,0
5139,5138,5138,5138,2030,24,271,24,145,2030,126,24,129,121,120,24,24,271,126,28,28,0,24,4,4,4,4,3,2,2,2,2,8,8,1,2024-01-06 22:38:00,0
5086,5087,5087,5087,2021,24,229,24,145,2021,84,24,126,121,118,24,24,229,84,28,28,2,24,4,4,4,4,4,6,2,2,2,5,5,0,2024-01-06 22:40:00,0
5103,5103,5103,5103,2017,23,262,23,149,2017,113,23,128,119,118,23,23,262,113,31,31,0,23,7,7,7,7,7,2,2,2,2,9,9,0,2024-01-06 22:42:00,0
5127,5128,5127,5127,2021,24,266,24,145,2021,121,24,133,121,119,24,24,266,121,28,28,2,24,4,4,4,4,4,4,2,2,2,12,12,0,2024-01-06 22:44:00,0
5128,5128,5128,5128,2020,24,278,24,144,2020,134,24,131,124,119,24,24,278,134,28,28,0,24,4,4,4,4,4,10,2,2,2,7,7,0,2024-01-06 22:46:00,0
5119,5118,5118,5118,2024,24,263,24,149,2024,114,24,126,122,118,24,24,263,114,31,31,0,24,7,7,7,7,6,8,2,2,2,4,4,1,2024-01-06 22:48:00,0
5141,5142,5142,5142,2020,24,290,24,145,2020,145,24,124,120,118,24,24,290,145,28,28,2,24,4,4,4,4,4,4,2,2,2,4,4,0,2024-01-06 22:50:00,0
5128,5128,5128,5128,2029,23,353,23,145,2029,208,23,134,123,120,23,23,353,208,28,28,0,23,4,4,4,4,4,6,2,2,2,11,11,0,2024-01-06 22:52:00,0
5120,5120,5120,5120,2031,24,246,24,146,2031,100,24,130,121,118,24,24,246,100,28,28,0,24,4,4,4,4,4,6,2,2,2,9,9,0,2024-01-06 22:54:00,0
5135,5153,5134,5134,2031,24,264,24,148,2031,116,24,128,122,118,24,24,264,116,31,31,0,24,7,7,7,7,7,8,2,2,2,6,6,0,2024-01-06 22:56:00,0
5144,5145,5145,5145,2032,24,268,24,145,2032,123,24,134,124,119,24,24,268,123,28,28,0,24,4,4,4,4,4,10,2,2,2,10,10,0,2024-01-06 22:58:00,0
5081,5080,5080,5080,2005,24,256,24,144,2005,112,24,130,122,118,24,24,256,112,27,27,3,24,3,3,3,3,3,8,2,2,2,8,8,0,2024-01-06 23:00:00,0
5103,5104,5104,5104,2017,24,256,24,145,2017,111,24,129,122,118,24,24,256,111,28,28,0,24,4,4,4,4,3,8,2,2,2,7,7,1,2024-01-06 23:02:00,0
5089,5088,5088,5088,2018,24,246,24,148,2018,98,24,127,121,119,24,24,246,98,31,31,0,24,7,7,7,7,7,4,2,2,2,6,6,0,2024-01-06 23:04:00,0
5137,5137,5137,5137,2023,23,272,23,145,2023,127,23,133,124,120,23,23,272,127,28,28,0,23,4,4,4,4,3,8,2,2,2,9,9,1,2024-01-06 23:06:00,0
5143,5143,5143,5143,2036,24,267,24,146,2036,121,24,125,122,118,24,24,267,121,28,28,0,24,4,4,4,4,4,8,2,2,2,3,3,0,2024-01-06 23:08:00,0
5113,5114,5114,5114,2030,24,240,24,145,2030,95,24,128,122,120,24,24,240,95,28,28,5,24,4,4,4,4,4,4,2,2,2,6,6,0,2024-01-06 23:10:00,0
5122,5121,5121,5121,2025,24,357,24,149,2025,208,24,135,123,119,24,24,357,208,31,31,0,24,7,7,7,7,7,8,2,2,2,12,12,0,2024-01-06 23:12:00,0
5096,5097,5097,5097,2017,24,249,24,144,2017,105,24,128,121,118,24,24,249,105,28,28,0,24,4,4,4,4,4,6,2,2,2,7,7,0,2024-01-06 23:14:00,0
5125,5125,5125,5125,2032,24,248,24,146,2032,102,24,131,124,119,24,24,248,102,28,28,4,24,4,4,4,4,3,10,2,2,2,7,7,1,2024-01-06 23:16:00,0
5167,5167,5167,5167,2040,24,368,24,145,2040,223,24,137,123,120,24,24,368,223,27,27,0,24,3,3,3,3,3,6,2,2,2,14,14,0,2024-01-06 23:18:00,0
5151,5151,5151,5151,2039,23,273,23,149,2039,124,23,125,120,119,23,23,273,124,31,31,4,23,7,7,7,7,7,2,2,2,2,5,5,0,2024-01-06 23:20:00,0
5112,5112,5112,5112,2014,24,377,24,145,2014,232,24,131,119,117,24,24,377,232,28,28,0,24,4,4,4,4,3,4,2,2,2,12,12,1,2024-01-06 23:22:00,0
5105,5103,5103,5103,2026,24,243,24,146,2026,97,24,127,119,118,24,24,243,97,28,28,0,24,4,4,4,4,4,2,2,2,2,8,8,0,2024-01-06 23:24:00,0
5135,5137,5137,5137,2026,24,273,24,148,2026,125,24,130,125,120,24,24,273,125,31,31,0,24,7,7,7,7,7,10,2,2,2,5,5,0,2024-01-06 23:26:00,0
5128,5128,5128,5128,2026,24,268,24,145,2026,123,24,127,120,118,24,24,268,123,28,28,0,24,4,4,4,4,4,4,2,2,2,7,7,0,2024-01-06 23:28:00,0
5141,5141,5141,5141,2031,24,268,24,146,2031,122,24,130,124,119,24,24,268,122,28,28,5,24,4,4,4,4,4,10,2,2,2,6,6,0,2024-01-06 23:30:00,0
5111,5111,5111,5111,2022,24,251,24,145,2022,106,24,126,120,118,24,24,251,106,28,28,0,24,4,4,4,4,3,4,2,2,2,6,6,1,2024-01-06 23:32:00,0
5132,5131,5131,5131,2030,23,264,23,148,2030,116,23,135,126,120,23,23,264,116,31,31,0,23,7,7,7,7,7,12,2,2,2,9,9,0,2024-01-06 23:34:00,0
5139,5139,5139,5139,2024,24,282,24,144,2024,138,24,126,120,118,24,24,282,138,27,27,4,24,3,3,3,3,3,4,2,2,2,6,6,0,2024-01-06 23:36:00,0
5146,5147,5147,5147,2033,24,365,24,146,2033,219,24,130,120,119,24,24,365,219,28,28,0,24,4,4,4,4,3,2,2,2,2,10,10,1,2024-01-06 23:38:00,0
5131,5131,5131,5131,2025,24,266,24,145,2025,121,24,133,121,120,24,24,266,121,28,28,0,24,4,4,4,4,4,2,2,2,2,12,12,0,2024-01-06 23:40:00,0
5149,5148,5148,5148,2029,24,380,24,149,2029,231,24,133,122,119,24,24,380,231,31,31,2,24,7,7,7,7,7,6,2,2,2,11,11,0,2024-01-06 23:42:00,0
5109,5109,5109,5109,2021,24,244,24,145,2021,99,24,138,129,121,24,24,244,99,28,28,0,24,4,4,4,4,4,16,2,2,2,9,9,0,2024-01-06 23:44:00,0
5129,5130,5130,5130,2026,23,270,23,145,2026,125,23,135,122,118,23,23,270,125,28,28,2,23,4,4,4,4,4,8,2,2,2,13,13,0,2024-01-06 23:46:00,0
5124,5123,5123,5123,2031,24,349,24,146,2031,203,24,130,121,119,24,24,349,203,28,28,0,24,4,4,4,4,3,4,2,2,2,9,9,1,2024-01-06 23:48:00,0
5121,5141,5121,5121,2028,24,301,24,149,2028,152,24,136,126,119,24,24,301,101,32,32,0,24,8,8,7,7,7,14,2,2,2,10,10,0,2024-01-06 23:50:00,52
5110,5110,5110,5110,2014,24,265,24,144,2014,121,24,130,122,118,24,24,265,121,27,27,4,24,3,3,3,3,3,8,2,2,2,8,8,0,2024-01-06 23:52:00,0
5136,5137,5137,5137,2026,24,268,24,145,2026,123,24,134,120,119,24,24,268,123,28,28,0,24,4,4,4,4,3,2,2,2,2,14,14,1,2024-01-06 23:54:00,0
5125,5123,5123,5123,2021,24,266,24,145,2021,121,24,130,122,118,24,24,266,121,28,28,4,24,4,4,4,4,4,8,2,2,2,8,8,0,2024-01-06 23:56:00,0
5102,5103,5103,5103,2014,24,263,24,147,2014,116,24,128,121,120,24,24,263,116,31,31,0,24,7,7,7,7,6,2,2,2,2,7,7,1,2024-01-06 23:58:00,0
5156,5156,5156,5156,2027,23,286,23,146,2027,140,23,129,122,119,23,23,286,140,28,28,0,23,4,4,4,4,4,6,2,2,2,7,7,0,2024-01-07 00:00:00,0
5111,5111,5111,5111,2011,24,668,24,145,2011,523,24,141,123,118,24,24,668,523,28,28,0,24,4,4,4,4,4,10,2,2,2,18,18,0,2024-01-07 00:02:00,0
5109,5108,5108,5108,2020,24,255,24,148,2020,107,24,130,119,118,24,24,255,107,31,31,0,24,7,7,7,7,7,2,2,2,2,11,11,0,2024-01-07 00:04:00,0
5112,5114,5114,5114,2029,24,249,24,145,2029,104,24,126,119,118,24,24,249,104,28,28,2,24,4,4,4,4,4,2,2,2,2,7,7,0,2024-01-07 00:06:00,0
5101,5100,5100,5100,2013,24,268,24,142,2013,126,24,130,122,118,24,24,268,126,26,26,1,24,3,3,3,3,3,8,2,2,2,8,8,0,2024-01-07 00:08:00,0
5113,5113,5113,5113,2025,23,258,23,146,2025,112,23,125,119,119,23,23,258,112,29,29,0,23,4,4,4,4,3,0,2,2,2,6,6,1,2024-01-07 00:10:00,0
5119,5119,5119,5119,2021,24,261,24,148,2021,113,24,132,122,119,24,24,261,113,31,31,2,24,7,7,7,7,7,6,2,2,2,10,10,0,2024-01-07 00:12:00,0
5131,5132,5132,5132,2019,24,280,24,145,2019,135,24,133,124,118,24,24,280,135,28,28,0,24,4,4,4,4,3,12,2,2,2,9,9,1,2024-01-07 00:14:00,0
5141,5140,5140,5140,2022,24,280,24,145,2022,135,24,133,121,118,24,24,280,135,28,28,0,24,4,4,4,4,4,6,2,2,2,12,12,0,2024-01-07 00:16:00,0
5119,5120,5120,5120,2020,24,360,24,145,2020,215,24,131,120,119,24,24,360,215,28,28,2,24,4,4,4,4,4,2,2,2,2,11,11,0,2024-01-07 00:18:00,0
5127,5127,5127,5127,2025,24,268,24,149,2025,119,24,128,119,118,24,24,268,119,31,31,0,24,7,7,7,7,7,2,2,2,2,9,9,0,2024-01-07 00:20:00,0
5150,5150,5150,5150,2029,24,277,24,145,2029,132,24,131,124,119,24,24,277,132,28,28,0,24,4,4,4,4,4,10,2,2,2,7,7,0,2024-01-07 00:22:00,0
5126,5125,5125,5125,2029,24,249,24,145,2029,104,24,132,122,118,24,24,249,104,27,27,0,24,3,3,3,3,3,8,2,2,2,10,10,0,2024-01-07 00:24:00,0
5142,5143,5143,5143,2032,23,264,23,145,2032,119,23,134,121,118,23,23,264,119,28,28,0,23,4,4,4,4,3,6,2,2,2,13,13,1,2024-01-07 00:26:00,0
5100,5099,5099,5099,2025,24,350,24,148,2025,202,24,126,121,118,24,24,350,202,31,31,5,24,7,7,7,7,7,6,2,2,2,5,5,0,2024-01-07 00:28:00,0
5132,5134,5133,5133,2030,24,258,24,146,2030,112,24,130,122,119,24,24,258,112,28,28,0,24,4,4,4,4,3,6,2,2,2,8,8,1,2024-01-07 00:30:00,0
5098,5098,5098,5098,2014,24,263,24,143,2014,120,24,132,119,117,24,24,263,120,27,27,2,24,4,4,4,4,4,4,2,2,2,13,13,0,2024-01-07 00:32:00,0
5124,5122,5122,5122,2025,24,260,24,145,2025,115,24,129,121,120,24,24,260,115,28,28,0,24,4,4,4,4,4,2,2,2,2,8,8,0,2024-01-07 00:34:00,0
5123,5124,5124,5124,2030,24,252,24,149,2030,103,24,133,124,120,24,24,252,103,31,31,0,24,7,7,7,7,7,8,2,2,2,9,9,0,2024-01-07 00:36:00,0
5090,5091,5091,5091,2015,23,253,23,144,2015,109,23,123,118,118,23,23,253,109,28,28,2,23,4,4,4,4,4,0,2,2,2,5,5,0,2024-01-07 00:38:00,0
5117,5117,5117,5117,2026,24,255,24,146,2026,109,24,130,121,119,24,24,255,109,28,28,0,24,4,4,4,4,3,4,2,2,2,9,9,1,2024-01-07 00:40:00,0
5094,5094,5094,5094,2023,24,237,24,144,2023,93,24,128,123,118,24,24,237,93,27,27,0,24,3,3,3,3,3,10,2,2,2,5,5,0,2024-01-07 00:42:00,0
5092,5091,5091,5091,2015,24,261,24,147,2015,114,24,125,118,118,24,24,261,114,31,31,2,24,7,7,7,7,7,0,2,2,2,7,7,0,2024-01-07 00:44:00,0
5149,5150,5150,5150,2029,24,281,24,146,2029,135,24,131,120,118,24,24,281,135,28,28,0,24,4,4,4,4,3,4,2,2,2,11,11,1,2024-01-07 00:46:00,0
5139,5138,5138,5138,2029,24,366,24,145,2029,221,24,135,124,118,24,24,366,221,28,28,2,24,4,4,4,4,4,12,2,2,2,11,11,0,2024-01-07 00:48:00,0
5129,5130,5130,5130,2020,24,281,24,149,2020,132,24,130,119,118,24,24,281,132,32,32,0,24,8,8,8,8,8,2,2,2,2,11,11,0,2024-01-07 00:50:00,0
5111,5111,5111,5111,2023,23,256,23,144,2023,112,23,127,119,119,23,23,256,112,27,27,0,23,3,3,3,3,3,0,2,2,2,8,8,0,2024-01-07 00:52:00,0
5121,5121,5121,5121,2032,24,245,24,145,2032,100,24,129,123,118,24,24,245,100,28,28,2,24,4,4,4,4,3,10,2,2,2,6,6,1,2024-01-07 00:54:00,0
5108,5108,5108,5108,2011,24,281,24,145,2011,136,24,129,124,119,24,24,281,136,28,28,0,24,4,4,4,4,4,10,2,2,2,5,5,0,2024-01-07 00:56:00,0
5113,5112,5112,5112,2026,24,257,24,148,2026,109,24,129,122,119,24,24,257,109,31,31,4,24,7,7,7,7,6,6,2,2,2,7,7,1,2024-01-07 00:58:00,0
5125,5126,5126,5126,2028,24,257,24,145,2028,112,24,128,121,118,24,24,257,112,28,28,0,24,4,4,4,4,4,6,2,2,2,7,7,0,2024-01-07 01:00:00,0
5137,5137,5137,5137,2003,24,507,24,145,2003,362,24,138,122,118,24,24,507,362,28,28,0,24,4,4,4,4,4,8,2,2,2,16,16,0,2024-01-07 01:02:00,0
5119,5118,5118,5118,2020,23,367,23,144,2020,223,23,132,120,118,23,23,367,223,27,27,4,23,3,3,3,3,3,4,2,2,2,12,12,0,2024-01-07 01:04:00,0
5124,5125,5125,5125,2018,24,279,24,149,2018,130,24,129,121,119,24,24,279,130,32,32,0,24,8,8,8,8,8,4,2,2,2,8,8,0,2024-01-07 01:06:00,0
5127,5127,5127,5127,2033,24,249,24,144,2033,105,24,131,119,118,24,24,249,105,27,27,0,24,3,3,3,3,3,2,2,2,2,12,12,0,2024-01-07 01:08:00,0
5115,5114,5114,5114,2026,24,262,24,153,2026,109,24,129,119,118,24,24,262,109,36,36,0,24,4,4,4,4,3,2,2,2,2,10,10,1,2024-01-07 01:10:00,20
5129,5129,5129,5129,2024,24,265,24,145,2024,120,24,131,123,121,24,24,265,120,28,28,1,24,4,4,4,4,3,4,2,2,2,8,8,1,2024-01-07 01:12:00,0
5123,5143,5124,5124,2030,24,250,24,149,2030,101,24,135,120,118,24,24,250,101,31,31,2,24,7,7,7,7,7,4,2,2,2,15,15,0,2024-01-07 01:14:00,0
5104,5103,5103,5103,2014,23,257,23,145,2014,112,23,134,123,118,23,23,257,112,28,28,0,23,4,4,4,4,4,10,2,2,2,11,11,0,2024-01-07 01:16:00,0
5107,5108,5108,5108,2025,24,247,24,144,2025,103,24,127,120,118,24,24,247,103,27,27,0,24,3,3,3,3,3,4,2,2,2,7,7,0,2024-01-07 01:18:00,0
5071,5071,5071,5071,2006,24,251,24,144,2006,107,24,128,119,117,24,24,251,107,28,28,0,24,4,4,4,4,4,4,2,2,2,9,9,0,2024-01-07 01:20:00,0
5125,5125,5125,5125,2028,24,268,24,149,2028,119,24,126,119,118,24,24,268,119,31,31,0,24,7,7,7,7,7,2,2,2,2,7,7,0,2024-01-07 01:22:00,0
5103,5105,5103,5103,2021,24,250,24,145,2021,105,24,122,118,118,24,24,250,105,28,28,5,24,4,4,4,4,3,0,2,2,2,4,4,1,2024-01-07 01:24:00,0
5166,5165,5164,5164,2027,24,295,24,145,2027,150,24,135,122,119,24,24,295,150,28,28,0,24,4,4,4,4,4,6,2,2,2,13,13,0,2024-01-07 01:26:00,0
5101,5102,5102,5102,2018,24,265,24,148,2018,117,24,123,120,118,24,24,265,117,31,31,0,24,7,7,7,7,6,4,2,2,2,3,3,1,2024-01-07 01:28:00,0
5139,5139,5139,5139,2033,23,264,23,146,2033,118,23,128,122,119,23,23,264,118,28,28,2,23,4,4,4,4,4,6,2,2,2,6,6,0,2024-01-07 01:30:00,0
5114,5115,5115,5115,2025,24,255,24,145,2025,110,24,127,119,118,24,24,255,110,28,28,0,24,4,4,4,4,4,2,2,2,2,8,8,0,2024-01-07 01:32:00,0
5096,5095,5095,5095,2020,24,247,24,143,2020,104,24,125,121,118,24,24,247,104,27,27,2,24,3,3,3,3,3,6,2,2,2,4,4,0,2024-01-07 01:34:00,0
5134,5134,5134,5134,2031,24,258,24,150,2031,108,24,135,124,119,24,24,258,108,32,32,0,24,8,8,8,8,8,10,2,2,2,11,11,0,2024-01-07 01:36:00,0
5084,5085,5085,5085,2015,24,241,24,143,2015,98,24,125,120,118,24,24,241,98,27,27,0,24,3,3,3,3,3,4,2,2,2,5,5,0,2024-01-07 01:38:00,0
5136,5136,5136,5136,2036,24,255,24,146,2036,109,24,128,120,119,24,24,255,109,28,28,2,24,4,4,4,4,3,2,2,2,2,8,8,1,2024-01-07 01:40:00,0
5046,5045,5045,5045,1997,23,247,23,144,1997,103,23,128,122,117,23,23,247,103,28,28,0,23,4,4,4,4,4,10,2,2,2,6,6,0,2024-01-07 01:42:00,0
5083,5084,5084,5084,2020,24,235,24,148,2020,87,24,129,120,118,24,24,235,87,31,31,0,24,7,7,7,7,6,4,2,2,2,9,9,1,2024-01-07 01:44:00,0
5162,5160,5160,5160,2037,24,283,24,146,2037,137,24,127,122,119,24,24,283,137,28,28,5,24,4,4,4,4,4,6,2,2,2,5,5,0,2024-01-07 01:46:00,0
5180,5182,5182,5182,2039,24,288,24,146,2039,142,24,135,123,120,24,24,288,142,28,28,0,24,4,4,4,4,4,6,2,2,2,12,12,0,2024-01-07 01:48:00,0
5130,5130,5130,5130,2021,24,315,24,145,2021,170,24,139,126,119,24,24,315,119,28,28,0,24,4,4,3,3,3,14,2,2,2,13,13,0,2024-01-07 01:50:00,52
5158,5177,5158,5158,2032,24,386,24,149,2032,237,24,134,124,118,24,24,386,237,31,31,0,24,7,7,7,7,7,12,2,2,2,10,10,0,2024-01-07 01:52:00,0
5148,5148,5148,5148,2041,24,247,24,146,2041,101,24,137,124,119,24,24,247,101,28,28,1,24,4,4,4,4,3,10,2,2,2,13,13,1,2024-01-07 01:54:00,0
5139,5138,5139,5139,2030,24,265,24,145,2030,120,24,129,122,119,24,24,265,120,28,28,0,24,4,4,4,4,4,6,2,2,2,7,7,0,2024-01-07 01:56:00,0
5121,5120,5119,5119,2019,23,272,23,148,2019,124,23,133,123,117,23,23,272,124,31,31,0,23,7,7,7,7,6,12,2,2,2,10,10,1,2024-01-07 01:58:00,0
5115,5116,5116,5116,2019,24,264,24,145,2019,119,24,132,122,118,24,24,264,119,28,28,2,24,4,4,4,4,4,8,2,2,2,10,10,0,2024-01-07 02:00:00,0
5127,5128,5128,5128,2009,24,592,24,144,2009,448,24,132,122,118,24,24,592,448,28,28,0,24,4,4,4,4,4,8,2,2,2,10,10,0,2024-01-07 02:02:00,0
5106,5106,5106,5106,2015,24,368,24,144,2015,224,24,128,121,119,24,24,368,224,27,27,0,24,3,3,3,3,3,4,2,2,2,7,7,0,2024-01-07 02:04:00,0
5067,5066,5066,5066,2015,23,240,23,149,2015,91,23,126,122,117,23,23,240,91,32,32,4,23,8,8,8,8,8,10,2,2,2,4,4,0,2024-01-07 02:06:00,0
5127,5128,5128,5128,2037,24,241,24,144,2037,97,24,130,122,120,24,24,241,97,27,27,0,24,3,3,3,3,3,4,2,2,2,8,8,0,2024-01-07 02:08:00,0
5131,5131,5131,5131,2035,24,250,24,146,2035,104,24,132,122,118,24,24,250,104,28,28,3,24,4,4,4,4,3,8,2,2,2,10,10,1,2024-01-07 02:10:00,0
5105,5103,5103,5103,2018,24,259,24,148,2018,111,24,131,121,118,24,24,259,111,31,31,1,24,7,7,7,7,7,6,2,2,2,10,10,0,2024-01-07 02:12:00,0
5143,5145,5145,5145,2019,24,294,24,145,2019,149,24,129,121,118,24,24,294,149,28,28,0,24,4,4,4,4,3,6,2,2,2,8,8,1,2024-01-07 02:14:00,0
5116,5115,5115,5115,2013,24,274,24,144,2013,130,24,131,123,119,24,24,274,130,28,28,4,24,4,4,4,4,4,8,2,2,2,8,8,0,2024-01-07 02:16:00,0
5130,5130,5130,5130,2030,24,258,24,146,2030,112,24,131,121,119,24,24,258,112,28,28,0,24,4,4,4,4,4,4,2,2,2,10,10,0,2024-01-07 02:18:00,0
5140,5141,5141,5141,2026,24,274,24,148,2026,126,24,134,122,119,24,24,274,126,31,31,0,24,7,7,7,7,7,6,2,2,2,12,12,0,2024-01-07 02:20:00,0
5106,5126,5106,5106,2021,24,253,24,145,2021,108,24,130,121,119,24,24,253,108,28,28,2,24,4,4,4,4,4,4,2,2,2,9,9,0,2024-01-07 02:22:00,0
5130,5130,5130,5130,2018,23,286,23,145,2018,141,23,127,121,117,23,23,286,141,28,28,0,23,4,4,4,4,3,8,2,2,2,6,6,1,2024-01-07 02:24:00,0
5114,5113,5113,5113,2016,24,269,24,144,2016,125,24,134,120,118,24,24,269,125,27,27,4,24,3,3,3,3,3,4,2,2,2,14,14,0,2024-01-07 02:26:00,0
5148,5149,5149,5149,2035,24,267,24,149,2035,118,24,130,123,119,24,24,267,118,31,31,0,24,7,7,7,7,7,8,2,2,2,7,7,0,2024-01-07 02:28:00,0
5132,5130,5130,5130,2031,24,263,24,145,2031,118,24,127,121,118,24,24,263,118,28,28,0,24,4,4,4,4,3,6,2,2,2,6,6,1,2024-01-07 02:30:00,0
5079,5081,5081,5081,2017,23,239,23,145,2017,94,23,128,123,118,23,23,239,94,28,28,4,23,4,4,4,4,4,10,2,2,2,5,5,0,2024-01-07 02:32:00,0
5142,5141,5141,5141,2032,24,271,24,148,2032,123,24,131,124,118,24,24,271,123,31,31,0,24,7,7,7,7,7,12,2,2,2,7,7,0,2024-01-07 02:34:00,0
5124,5125,5125,5125,2026,24,264,24,145,2026,119,24,130,123,118,24,24,264,119,28,28,0,24,4,4,4,4,4,10,2,2,2,7,7,0,2024-01-07 02:36:00,0
5126,5126,5126,5126,2019,24,373,24,145,2019,228,24,131,118,118,24,24,373,228,28,28,0,24,4,4,4,4,4,0,2,2,2,13,13,0,2024-01-07 02:38:00,0
5158,5158,5158,5158,2036,24,272,24,146,2036,126,24,133,122,119,24,24,272,126,28,28,1,24,4,4,4,4,3,6,2,2,2,11,11,1,2024-01-07 02:40:00,0
5116,5116,5116,5116,2014,24,278,24,148,2014,130,24,129,118,117,24,24,278,130,31,31,4,24,7,7,7,7,7,2,2,2,2,11,11,0,2024-01-07 02:42:00,0
5105,5103,5103,5103,2023,24,244,24,144,2023,100,24,132,124,118,24,24,244,100,27,27,0,24,3,3,3,3,3,12,2,2,2,8,8,0,2024-01-07 02:44:00,0
5115,5117,5117,5117,2016,24,270,24,145,2016,125,24,128,120,118,24,24,270,125,28,28,0,24,4,4,4,4,3,4,2,2,2,8,8,1,2024-01-07 02:46:00,0
5102,5101,5101,5101,2019,24,253,24,145,2019,108,24,127,120,118,24,24,253,108,28,28,0,24,4,4,4,4,4,4,2,2,2,7,7,0,2024-01-07 02:48:00,0
5069,5069,5069,5069,1999,23,326,23,148,1999,178,23,125,120,117,23,23,326,127,32,32,0,23,8,8,7,7,7,6,2,2,2,5,5,0,2024-01-07 02:50:00,52
5110,5111,5111,5111,2020,24,256,24,144,2020,112,24,128,120,118,24,24,256,112,28,28,5,24,4,4,4,4,4,4,2,2,2,8,8,0,2024-01-07 02:52:00,0
5135,5135,5135,5135,2028,24,263,24,146,2028,117,24,133,122,119,24,24,263,117,28,28,0,24,4,4,4,4,4,6,2,2,2,11,11,0,2024-01-07 02:54:00,0
6200,6200,6200,6200,2434,29,359,29,176,2434,183,29,164,148,142,29,29,359,183,36,36,8,29,7,7,7,7,7,12,3,3,3,16,16,0,2024-01-07 02:56:00,0
5090,5089,5089,5089,2014,23,258,23,143,2014,115,23,129,118,118,23,23,258,115,27,27,2,23,4,4,4,4,4,0,2,2,2,11,11,0,2024-01-07 02:58:00,0
5115,5116,5116,5116,2023,24,258,24,144,2023,114,24,129,122,119,24,24,258,114,27,27,0,24,3,3,3,3,3,6,2,2,2,7,7,0,2024-01-07 03:00:00,0
5194,5193,5193,5193,2021,24,427,24,146,2021,281,24,142,126,118,24,24,427,281,28,28,2,24,4,4,4,4,3,16,2,2,2,16,16,1,2024-01-07 03:02:00,0
5142,5142,5142,5142,2020,24,390,24,148,2020,242,24,133,121,118,24,24,390,242,31,31,0,24,7,7,7,7,7,6,2,2,2,12,12,0,2024-01-07 03:04:00,0
5107,5107,5107,5107,2020,24,256,24,144,2020,112,24,125,119,118,24,24,256,112,28,28,0,24,4,4,4,4,3,2,2,2,2,6,6,1,2024-01-07 03:06:00,0
5123,5124,5124,5124,2024,24,269,24,146,2024,123,24,124,120,119,24,24,269,123,28,28,2,24,4,4,4,4,4,2,2,2,2,4,4,0,2024-01-07 03:08:00,0
5162,5161,5161,5161,2037,24,277,24,149,2037,128,24,134,123,119,24,24,277,128,31,31,0,24,7,7,7,7,7,8,2,2,2,11,11,0,2024-01-07 03:10:00,0
5229,5230,5230,5230,2034,24,441,24,145,2034,296,24,139,123,119,24,24,441,296,28,28,3,24,4,4,4,4,4,8,2,2,2,16,16,0,2024-01-07 03:12:00,0
5124,5124,5124,5124,2027,24,257,24,146,2027,111,24,126,120,119,24,24,257,111,28,28,1,24,4,4,4,4,4,2,2,2,2,6,6,0,2024-01-07 03:14:00,0
5125,5145,5125,5125,2026,23,265,23,146,2026,119,23,131,121,118,23,23,265,119,29,29,0,23,4,4,4,4,3,6,2,2,2,10,10,1,2024-01-07 03:16:00,0
5141,5140,5140,5140,2017,24,288,24,147,2017,141,24,140,121,119,24,24,288,141,31,31,4,24,7,7,7,7,7,4,2,2,2,19,19,0,2024-01-07 03:18:00,0
5139,5140,5140,5140,2021,24,278,24,145,2021,133,24,131,120,118,24,24,278,133,28,28,0,24,4,4,4,4,4,4,2,2,2,11,11,0,2024-01-07 03:20:00,0
5092,5092,5092,5092,2000,23,283,23,142,2000,141,23,132,118,118,23,23,283,141,26,26,0,23,3,3,3,3,3,0,2,2,2,14,14,0,2024-01-07 03:22:00,0
5114,5114,5114,5114,2027,24,248,24,146,2027,102,24,127,122,119,24,24,248,102,28,28,0,24,4,4,4,4,4,6,2,2,2,5,5,0,2024-01-07 03:24:00,0
5109,5109,5109,5109,2022,24,258,24,148,2022,110,24,131,120,119,24,24,258,110,31,31,0,24,7,7,7,7,7,2,2,2,2,11,11,0,2024-01-07 03:26:00,0
5114,5112,5112,5112,2030,24,244,24,145,2030,99,24,129,121,120,24,24,244,99,28,28,5,24,4,4,4,4,3,2,2,2,2,8,8,1,2024-01-07 03:28:00,0
5119,5121,5121,5121,2025,24,257,24,145,2025,112,24,126,121,118,24,24,257,112,28,28,0,24,4,4,4,4,4,6,2,2,2,5,5,0,2024-01-07 03:30:00,0
5113,5113,5113,5113,2022,24,261,24,148,2022,113,24,131,123,120,24,24,261,113,31,31,0,24,7,7,7,7,6,6,2,2,2,8,8,1,2024-01-07 03:32:00,0
5106,5106,5106,5106,2020,24,252,24,145,2020,107,24,131,120,118,24,24,252,107,28,28,4,24,4,4,4,4,4,4,2,2,2,11,11,0,2024-01-07 03:34:00,0
5132,5132,5132,5132,2030,24,263,24,145,2030,118,24,129,123,119,24,24,263,118,28,28,0,24,4,4,4,4,4,8,2,2,2,6,6,0,2024-01-07 03:36:00,0
5120,5120,5120,5120,2026,24,354,24,144,2026,210,24,131,120,118,24,24,354,210,27,27,4,24,3,3,3,3,3,4,2,2,2,11,11,0,2024-01-07 03:38:00,0
5130,5130,5130,5130,2032,24,263,24,150,2032,113,24,128,121,118,24,24,263,113,32,32,0,24,8,8,8,8,8,6,2,2,2,7,7,0,2024-01-07 03:40:00,0
5127,5147,5127,5127,2024,23,368,23,144,2024,224,23,131,123,118,23,23,368,224,27,27,0,23,3,3,3,3,3,10,2,2,2,8,8,0,2024-01-07 03:42:00,0
5161,5159,5159,5159,2038,24,262,24,146,2038,116,24,138,125,120,24,24,262,116,28,28,2,24,4,4,4,4,3,10,2,2,2,13,13,1,2024-01-07 03:44:00,0
5064,5066,5066,5066,2012,24,239,24,145,2012,94,24,124,118,117,24,24,239,94,28,28,0,24,4,4,4,4,4,2,2,2,2,6,6,0,2024-01-07 03:46:00,0
5141,5140,5140,5140,2029,23,273,23,148,2029,125,23,131,122,118,23,23,273,125,31,31,0,23,7,7,7,7,6,8,2,2,2,9,9,1,2024-01-07 03:48:00,0
5129,5129,5129,5129,2016,24,281,24,145,2016,136,24,131,124,119,24,24,281,136,28,28,4,24,4,4,4,4,4,10,2,2,2,7,7,0,2024-01-07 03:50:00,0
5123,5123,5123,5123,2023,24,266,24,144,2023,122,24,131,121,119,24,24,266,122,28,28,0,24,4,4,4,4,4,4,2,2,2,10,10,0,2024-01-07 03:52:00,0
5113,5135,5114,5114,2024,24,261,24,148,2024,113,24,125,120,119,24,24,261,113,31,31,0,24,7,7,7,7,7,2,2,2,2,5,5,0,2024-01-07 03:54:00,0
5104,5101,5101,5101,2022,24,252,24,145,2022,107,24,128,120,118,24,24,252,107,28,28,0,24,4,4,4,4,4,4,2,2,2,8,8,0,2024-01-07 03:56:00,0
5160,5163,5163,5163,2023,24,290,24,145,2023,145,24,140,124,119,24,24,290,145,28,28,0,24,4,4,4,4,4,10,2,2,2,16,16,0,2024-01-07 03:58:00,0
5115,5115,5115,5115,2024,24,257,24,146,2024,111,24,128,121,119,24,24,257,111,28,28,3,24,4,4,4,4,3,4,2,2,2,7,7,1,2024-01-07 04:00:00,0
5132,5132,5132,5132,2013,24,593,24,147,2013,446,24,132,123,118,24,24,593,446,31,31,0,24,7,7,7,7,7,10,2,2,2,9,9,0,2024-01-07 04:02:00,0
5152,5151,5151,5151,2034,24,369,24,145,2034,224,24,130,120,118,24,24,369,224,27,27,4,24,3,3,3,3,3,4,2,2,2,10,10,0,2024-01-07 04:04:00,0
5123,5124,5124,5124,2021,24,268,24,145,2021,123,24,130,121,119,24,24,268,123,28,28,0,24,4,4,4,4,3,4,2,2,2,9,9,1,2024-01-07 04:06:00,0
5108,5107,5107,5107,2028,23,247,23,150,2028,97,23,129,120,118,23,23,247,97,32,32,0,23,8,8,8,8,8,4,2,2,2,9,9,0,2024-01-07 04:08:00,0
5065,5066,5066,5066,2001,24,244,24,142,2001,102,24,139,120,117,24,24,244,102,27,27,2,24,3,3,3,3,3,6,2,2,2,19,19,0,2024-01-07 04:10:00,0
5113,5113,5113,5113,2025,23,349,23,146,2025,203,23,133,121,119,23,23,349,203,28,28,0,23,4,4,4,4,4,4,2,2,2,12,12,0,2024-01-07 04:12:00,0
5123,5123,5123,5123,2028,24,259,24,145,2028,114,24,128,120,119,24,24,259,114,28,28,2,24,4,4,4,4,4,2,2,2,2,8,8,0,2024-01-07 04:14:00,0
5130,5129,5129,5129,2018,24,283,24,148,2018,135,24,131,124,118,24,24,283,135,31,31,2,24,7,7,7,7,6,12,2,2,2,7,7,1,2024-01-07 04:16:00,0
5111,5112,5112,5112,2021,24,255,24,145,2021,110,24,130,124,118,24,24,255,110,28,28,0,24,4,4,4,4,4,12,2,2,2,6,6,0,2024-01-07 04:18:00,0
5112,5112,5112,5112,2015,24,266,24,144,2015,122,24,130,124,119,24,24,266,122,28,28,2,24,4,4,4,4,3,10,2,2,2,6,6,1,2024-01-07 04:20:00,0
5130,5129,5130,5130,2014,24,280,24,145,2014,135,24,134,127,118,24,24,280,135,27,27,0,24,3,3,3,3,3,18,2,2,2,7,7,0,2024-01-07 04:22:00,0
5147,5148,5147,5147,2030,24,276,24,149,2030,127,24,134,126,119,24,24,276,127,32,32,0,24,8,8,8,8,8,14,2,2,2,8,8,0,2024-01-07 04:24:00,0
5139,5139,5139,5139,2028,24,272,24,144,2028,128,24,126,121,119,24,24,272,128,27,27,4,24,3,3,3,3,3,4,2,2,2,5,5,0,2024-01-07 04:26:00,0
5118,5118,5118,5118,2021,24,265,24,145,2021,120,24,130,122,118,24,24,265,120,28,28,0,24,4,4,4,4,4,8,2,2,2,8,8,0,2024-01-07 04:28:00,0
5137,5138,5137,5137,2030,24,271,24,149,2030,122,24,127,122,119,24,24,271,122,31,31,4,24,7,7,7,7,7,6,2,2,2,5,5,0,2024-01-07 04:30:00,0
5121,5121,5121,5121,2032,24,251,24,145,2032,106,24,128,118,118,24,24,251,106,28,28,0,24,4,4,4,4,3,0,2,2,2,10,10,1,2024-01-07 04:32:00,0
5064,5064,5064,5064,2009,23,242,23,144,2009,98,23,126,122,117,23,23,242,98,28,28,0,23,4,4,4,4,4,10,2,2,2,4,4,0,2024-01-07 04:34:00,0
5118,5116,5116,5116,2034,24,237,24,146,2034,91,24,134,122,119,24,24,237,91,28,28,4,24,4,4,4,4,3,6,2,2,2,12,12,1,2024-01-07 04:36:00,0
5116,5118,5118,5118,2021,23,261,23,148,2021,113,23,133,122,120,23,23,261,113,31,31,0,23,7,7,7,7,7,4,2,2,2,11,11,0,2024-01-07 04:38:00,0
5136,5135,5135,5135,2032,24,267,24,145,2032,122,24,125,118,118,24,24,267,122,28,28,4,24,4,4,4,4,4,0,2,2,2,7,7,0,2024-01-07 04:40:00,0
5106,5107,5107,5107,2019,24,360,24,145,2019,215,24,125,118,118,24,24,360,215,27,27,0,24,3,3,3,3,3,0,2,2,2,7,7,0,2024-01-07 04:42:00,0
5126,5126,5126,5126,2025,24,264,24,145,2025,119,24,131,121,118,24,24,264,119,28,28,0,24,4,4,4,4,4,6,2,2,2,10,10,0,2024-01-07 04:44:00,0
5129,5129,5129,5129,2024,24,278,24,148,2024,130,24,127,121,118,24,24,278,130,31,31,2,24,7,7,7,7,7,6,2,2,2,6,6,0,2024-01-07 04:46:00,0
5134,5133,5133,5133,2038,24,352,24,145,2038,207,24,127,119,119,24,24,352,207,28,28,0,24,4,4,4,4,3,0,2,2,2,8,8,1,2024-01-07 04:48:00,0
5155,5156,5156,5156,2031,24,277,24,146,2031,131,24,135,122,118,24,24,277,131,28,28,0,24,4,4,4,4,4,8,2,2,2,13,13,0,2024-01-07 04:50:00,0
5418,5417,5417,5417,2021,66,416,66,186,2021,230,66,176,166,164,66,66,416,230,32,32,4,66,8,8,8,8,8,4,2,2,2,10,10,0,2024-01-07 04:52:00,0
5593,5593,5593,5593,2035,92,327,92,214,2035,113,92,203,191,187,92,92,327,113,27,27,0,92,3,3,3,3,3,8,2,2,2,12,12,0,2024-01-07 04:54:00,0
5579,5580,5580,5580,2034,98,314,98,211,2034,103,98,190,185,183,98,98,314,103,28,28,2,98,4,4,4,4,4,4,2,2,2,5,5,0,2024-01-07 04:56:00,0
5506,5505,5505,5505,2006,86,306,86,217,2006,89,86,195,183,180,86,86,306,89,28,28,0,86,4,4,4,4,4,6,2,2,2,12,12,0,2024-01-07 04:58:00,0
5567,5568,5568,5568,2021,89,332,89,214,2021,118,89,203,190,188,89,89,332,118,31,31,0,89,7,7,7,7,6,4,2,2,2,13,13,1,2024-01-07 05:00:00,0
5624,5622,5623,5623,2015,93,555,93,212,2015,343,93,218,204,199,93,93,555,343,28,28,0,93,4,4,4,4,4,10,2,2,2,14,14,0,2024-01-07 05:02:00,0
5612,5613,5613,5613,2034,89,425,89,215,2034,210,89,208,190,189,89,89,425,210,28,28,0,89,4,4,4,4,3,2,2,2,2,18,18,1,2024-01-07 05:04:00,0
5603,5623,5603,5603,2036,91,348,91,221,2036,127,91,197,194,189,91,91,348,127,31,31,5,91,7,7,7,7,7,10,2,2,2,3,3,0,2024-01-07 05:06:00,0
5590,5590,5590,5590,2027,95,317,95,210,2027,107,95,187,183,179,95,95,317,107,28,28,0,95,4,4,4,4,4,8,2,2,2,4,4,0,2024-01-07 05:08:00,0
5621,5621,5621,5621,2032,91,339,91,213,2032,126,91,206,199,195,91,91,339,126,27,27,0,91,3,3,3,3,3,8,2,2,2,7,7,0,2024-01-07 05:10:00,0
5577,5576,5576,5576,2027,90,314,90,206,2027,108,90,194,186,182,90,90,314,108,28,28,4,90,4,4,4,4,4,8,2,2,2,8,8,0,2024-01-07 05:12:00,0
5627,5627,5627,5627,2029,92,354,92,222,2029,132,92,207,196,192,92,92,354,132,31,31,0,92,7,7,7,7,7,8,2,2,2,11,11,0,2024-01-07 05:14:00,0
5635,5636,5636,5636,2040,82,351,82,217,2040,134,82,202,195,190,82,82,351,134,28,28,2,82,4,4,4,4,3,10,2,2,2,7,7,1,2024-01-07 05:16:00,0
5584,5583,5583,5583,2033,85,323,85,209,2033,114,85,194,185,183,85,85,323,114,28,28,2,85,4,4,4,4,4,4,2,2,2,9,9,0,2024-01-07 05:18:00,0
5573,5575,5574,5574,2026,95,339,95,211,2026,128,95,190,180,176,95,95,339,128,28,28,0,95,4,4,4,4,3,8,2,2,2,10,10,1,2024-01-07 05:20:00,0
5531,5530,5530,5530,1999,95,321,95,214,1999,107,95,199,186,177,95,95,321,107,31,31,2,95,7,7,7,7,7,18,2,2,2,13,13,0,2024-01-07 05:22:00,0
5575,5575,5575,5575,2030,82,335,82,211,2030,124,82,192,183,183,82,82,335,124,28,28,0,82,4,4,4,4,4,0,2,2,2,9,9,0,2024-01-07 05:24:00,0
5587,5587,5587,5587,2030,98,325,98,220,2030,105,98,196,191,190,98,98,325,105,27,27,0,98,3,3,3,3,3,2,2,2,2,5,5,0,2024-01-07 05:26:00,0
5612,5613,5613,5613,2038,96,342,96,225,2038,117,96,186,174,173,96,96,342,117,32,32,6,96,8,8,8,8,8,2,2,2,2,12,12,0,2024-01-07 05:28:00,0
5583,5581,5581,5581,2031,92,319,92,207,2031,112,92,207,199,196,92,92,319,112,27,27,0,92,3,3,3,3,3,6,2,2,2,8,8,0,2024-01-07 05:30:00,0
5649,5651,5651,5651,2039,93,342,93,212,2039,130,93,210,196,192,93,93,342,130,28,28,0,93,4,4,4,4,3,8,2,2,2,14,14,1,2024-01-07 05:32:00,0
5580,5577,5577,5577,2020,98,323,98,222,2020,101,98,194,180,179,98,98,323,101,28,28,0,98,4,4,4,4,4,2,2,2,2,14,14,0,2024-01-07 05:34:00,0
5613,5616,5616,5616,2039,91,339,91,228,2039,111,91,208,197,193,91,91,339,111,31,31,1,91,7,7,7,7,6,8,2,2,2,11,11,1,2024-01-07 05:36:00,0
5594,5594,5594,5594,2035,105,325,105,224,2035,101,105,187,182,176,105,105,325,101,28,28,0,105,4,4,4,4,4,12,2,2,2,5,5,0,2024-01-07 05:38:00,0
5641,5641,5641,5641,2028,99,335,99,212,2028,123,99,205,199,194,99,99,335,123,28,28,0,99,4,4,4,4,4,10,2,2,2,6,6,0,2024-01-07 05:40:00,0
5590,5589,5589,5589,2032,89,310,89,209,2032,101,89,199,193,192,89,89,310,101,27,27,4,89,3,3,3,3,3,2,2,2,2,6,6,0,2024-01-07 05:42:00,0
5592,5593,5593,5593,2034,93,331,93,212,2034,119,93,203,191,187,93,93,331,119,32,32,0,93,8,8,8,8,8,8,2,2,2,12,12,0,2024-01-07 05:44:00,0
5520,5520,5520,5520,2010,92,301,92,212,2010,89,92,197,190,189,92,92,301,89,26,26,0,92,3,3,3,3,3,2,2,2,2,7,7,0,2024-01-07 05:46:00,0
5607,5607,5607,5607,2028,103,338,103,214,2028,124,103,194,187,185,103,103,338,124,28,28,4,103,4,4,4,4,3,4,2,2,2,7,7,1,2024-01-07 05:48:00,0
5579,5578,5578,5578,2019,93,339,93,216,2019,123,93,200,190,185,93,93,339,123,32,32,0,93,8,8,8,8,8,10,2,2,2,10,10,0,2024-01-07 05:50:00,0
5668,5669,5669,5669,2023,98,468,98,220,2023,248,98,212,202,196,98,98,468,248,27,27,0,98,3,3,3,3,3,12,2,2,2,10,10,0,2024-01-07 05:52:00,0
5617,5615,5615,5615,2031,94,342,94,210,2031,132,94,204,195,193,94,94,342,132,28,28,2,94,4,4,4,4,3,4,2,2,2,9,9,1,2024-01-07 05:54:00,0
5586,5588,5587,5587,2031,87,325,87,209,2031,116,87,211,206,200,87,87,325,116,28,28,0,87,4,4,4,4,4,12,2,2,2,5,5,0,2024-01-07 05:56:00,0
5544,5544,5545,5545,2027,75,321,75,216,2027,105,75,193,186,182,75,75,321,105,31,31,4,75,7,7,7,7,6,8,2,2,2,7,7,1,2024-01-07 05:58:00,0
5570,5570,5570,5570,2034,97,311,97,206,2034,105,97,194,182,181,97,97,311,105,28,28,0,97,4,4,4,4,4,2,2,2,2,12,12,0,2024-01-07 06:00:00,0
5626,5625,5625,5625,2017,101,669,101,215,2017,454,101,195,181,178,101,101,669,454,28,28,0,101,4,4,4,4,4,6,2,2,2,14,14,0,2024-01-07 06:02:00,0
5564,5564,5564,5564,2023,89,311,89,220,2023,91,89,208,196,196,89,89,311,91,31,31,4,89,7,7,7,7,7,0,2,2,2,12,12,0,2024-01-07 06:04:00,0
5540,5540,5540,5540,2023,89,313,89,203,2023,110,89,192,187,182,89,89,313,110,29,29,0,89,4,4,4,4,4,10,2,2,2,5,5,0,2024-01-07 06:06:00,0
5608,5609,5609,5609,2027,94,326,94,213,2027,113,94,211,205,203,94,94,326,113,27,27,2,94,3,3,3,3,3,4,2,2,2,6,6,0,2024-01-07 06:08:00,0
5567,5567,5567,5567,2010,90,344,90,213,2010,131,90,194,186,181,90,90,344,131,27,27,0,90,4,4,4,4,3,10,2,2,2,8,8,1,2024-01-07 06:10:00,0
5603,5601,5601,5601,2028,94,330,94,220,2028,110,94,193,185,183,94,94,330,110,32,32,0,94,8,8,8,8,8,4,2,2,2,8,8,0,2024-01-07 06:12:00,0
5567,5567,5567,5567,2022,95,323,95,215,2022,108,95,207,197,195,95,95,323,108,27,27,4,95,3,3,3,3,3,4,2,2,2,10,10,0,2024-01-07 06:14:00,0
5594,5595,5595,5595,2017,94,339,94,204,2017,135,94,212,205,201,94,94,339,135,28,28,0,94,4,4,4,4,4,8,2,2,2,7,7,0,2024-01-07 06:16:00,0
5587,5588,5588,5588,2027,90,318,90,215,2027,103,90,198,185,185,90,90,318,103,28,28,0,90,4,4,4,4,4,0,2,2,2,13,13,0,2024-01-07 06:18:00,0
5550,5549,5549,5549,2025,94,311,94,204,2025,107,94,203,194,193,94,94,311,107,31,31,0,94,7,7,7,7,6,2,2,2,2,9,9,1,2024-01-07 06:20:00,0
5567,5566,5566,5566,2017,94,416,94,204,2017,212,94,198,183,182,94,94,416,212,28,28,0,94,4,4,4,4,4,2,2,2,2,15,15,0,2024-01-07 06:22:00,0
5622,5623,5623,5623,2023,86,353,86,228,2023,125,86,208,197,195,86,86,353,125,28,28,3,86,4,4,4,4,3,4,2,2,2,11,11,1,2024-01-07 06:24:00,0
5586,5587,5587,5587,2028,95,317,95,212,2028,105,95,198,192,187,95,95,317,105,31,31,0,95,7,7,7,7,7,10,2,2,2,6,6,0,2024-01-07 06:26:00,0
5600,5600,5600,5600,2021,95,446,95,224,2021,222,95,197,189,188,95,95,446,222,28,28,0,95,4,4,4,4,4,2,2,2,2,8,8,0,2024-01-07 06:28:00,0
5577,5575,5575,5575,2031,90,323,90,206,2031,117,90,202,197,196,90,90,323,117,27,27,4,90,3,3,3,3,3,2,2,2,2,5,5,0,2024-01-07 06:30:00,0
5575,5577,5577,5577,2019,102,325,102,214,2019,111,102,207,200,195,102,102,325,111,28,28,0,102,4,4,4,4,4,10,2,2,2,7,7,0,2024-01-07 06:32:00,0
5546,5545,5545,5545,2005,86,353,86,226,2005,127,86,202,193,190,86,86,353,127,31,31,4,86,7,7,7,7,7,6,2,2,2,9,9,0,2024-01-07 06:34:00,0
5594,5613,5594,5594,2032,83,322,83,216,2032,106,83,210,203,200,83,83,322,106,28,28,0,83,4,4,4,4,3,6,2,2,2,7,7,1,2024-01-07 06:36:00,0
5591,5592,5592,5592,2028,90,330,90,218,2028,112,90,196,186,185,90,90,330,112,28,28,0,90,4,4,4,4,4,2,2,2,2,10,10,0,2024-01-07 06:38:00,0
5566,5566,5566,5566,2027,89,320,89,222,2027,98,89,196,188,185,89,89,320,98,28,28,2,89,4,4,4,4,3,6,2,2,2,8,8,1,2024-01-07 06:40:00,0
5592,5591,5591,5591,2018,94,337,94,215,2018,122,94,196,187,185,94,94,337,122,31,31,0,94,7,7,7,7,7,4,2,2,2,9,9,0,2024-01-07 06:42:00,0
5579,5578,5578,5578,2020,93,336,93,213,2020,123,93,210,196,194,93,93,336,123,28,28,1,93,4,4,4,4,4,4,2,2,2,14,14,0,2024-01-07 06:44:00,0
5556,5557,5557,5557,2017,92,324,92,202,2017,122,92,196,189,186,92,92,324,122,27,27,1,92,3,3,3,3,3,6,2,2,2,7,7,0,2024-01-07 06:46:00,0
5565,5565,5565,5565,2031,85,323,85,220,2031,103,85,194,181,179,85,85,323,103,32,32,0,85,8,8,8,8,8,4,2,2,2,13,13,0,2024-01-07 06:48:00,0
5568,5568,5568,5568,2033,92,361,92,210,2033,151,92,195,189,187,92,92,361,100,28,28,4,92,4,4,3,3,3,4,2,2,2,6,6,0,2024-01-07 06:50:00,52
5576,5577,5577,5577,2022,98,429,98,211,2022,218,98,188,180,178,98,98,429,218,28,28,0,98,4,4,4,4,4,4,2,2,2,8,8,0,2024-01-07 06:52:00,0
5620,5620,5620,5620,2030,104,339,104,207,2030,132,104,199,190,185,104,104,339,132,28,28,0,104,4,4,4,4,4,10,2,2,2,9,9,0,2024-01-07 06:54:00,0
5566,5565,5565,5565,2025,85,315,85,227,2025,88,85,198,187,186,85,85,315,88,31,31,4,85,7,7,7,7,7,2,2,2,2,11,11,0,2024-01-07 06:56:00,0
5566,5567,5567,5567,2023,95,316,95,214,2023,102,95,198,192,190,95,95,316,102,28,28,0,95,4,4,4,4,4,4,2,2,2,6,6,0,2024-01-07 06:58:00,0
5558,5557,5557,5557,2026,89,315,89,204,2026,111,89,191,185,184,89,89,315,111,28,28,4,89,4,4,4,4,3,2,2,2,2,6,6,1,2024-01-07 07:00:00,0
5583,5584,5584,5584,2011,84,469,84,222,2011,247,84,208,198,193,84,84,469,247,27,27,0,84,3,3,3,3,3,10,2,2,2,10,10,0,2024-01-07 07:02:00,0
5585,5585,5585,5585,2031,97,416,97,217,2031,199,97,200,190,186,97,97,416,199,31,31,0,97,7,7,7,7,7,8,2,2,2,10,10,0,2024-01-07 07:04:00,0
5593,5592,5592,5592,2026,96,340,96,207,2026,133,96,191,184,184,96,96,340,133,28,28,0,96,4,4,4,4,3,0,2,2,2,7,7,1,2024-01-07 07:06:00,0
5556,5557,5557,5557,2016,95,430,95,204,2016,226,95,184,176,175,95,95,430,226,28,28,0,95,4,4,4,4,4,2,2,2,2,8,8,0,2024-01-07 07:08:00,0
5568,5568,5568,5568,2021,96,309,96,218,2021,91,96,201,193,190,96,96,309,91,31,31,1,96,7,7,7,7,7,6,2,2,2,8,8,0,2024-01-07 07:10:00,0
5565,5565,5565,5565,2026,98,336,98,214,2026,122,98,186,181,180,98,98,336,122,28,28,0,98,4,4,4,4,4,2,2,2,2,5,5,0,2024-01-07 07:12:00,0
5559,5559,5559,5559,2022,88,328,88,211,2022,117,88,193,188,184,88,88,328,117,28,28,0,88,4,4,4,4,4,8,2,2,2,5,5,0,2024-01-07 07:14:00,0
5582,5582,5582,5582,2024,84,328,84,208,2024,120,84,198,188,188,84,84,328,120,28,28,4,84,4,4,4,4,3,0,2,2,2,10,10,1,2024-01-07 07:16:00,0
5600,5598,5598,5598,2026,98,349,98,221,2026,128,98,199,184,181,98,98,349,128,31,31,0,98,7,7,7,7,7,6,2,2,2,15,15,0,2024-01-07 07:18:00,0
5589,5591,5591,5591,2020,89,336,89,212,2020,124,89,208,200,198,89,89,336,124,27,27,1,89,3,3,3,3,3,4,2,2,2,8,8,0,2024-01-07 07:20:00,0
5559,5558,5558,5558,2027,82,342,82,215,2027,127,82,190,187,184,82,82,342,127,28,28,1,82,4,4,4,4,3,6,2,2,2,3,3,1,2024-01-07 07:22:00,0
5564,5564,5564,5564,2006,95,335,95,231,2006,104,95,197,187,182,95,95,335,104,32,32,0,95,8,8,8,8,8,10,2,2,2,10,10,0,2024-01-07 07:24:00,0
5591,5593,5592,5592,2021,91,349,91,214,2021,135,91,204,193,191,91,91,349,135,27,27,0,91,3,3,3,3,3,4,2,2,2,11,11,0,2024-01-07 07:26:00,0
5597,5597,5597,5597,2032,92,325,92,224,2032,101,92,192,185,184,92,92,325,101,28,28,0,92,4,4,4,4,4,2,2,2,2,7,7,0,2024-01-07 07:28:00,0
5566,5567,5566,5566,2025,95,304,95,208,2025,96,95,198,191,189,95,95,304,96,28,28,1,95,4,4,4,4,4,4,2,2,2,7,7,0,2024-01-07 07:30:00,0
5600,5599,5599,5599,2011,91,346,91,219,2011,127,91,201,193,190,91,91,346,127,31,31,4,91,7,7,7,7,6,6,2,2,2,8,8,1,2024-01-07 07:32:00,0
5594,5595,5595,5595,2023,94,344,94,226,2023,118,94,202,191,187,94,94,344,118,28,28,0,94,4,4,4,4,4,8,2,2,2,11,11,0,2024-01-07 07:34:00,0
5580,5578,5578,5578,2027,94,329,94,225,2027,104,94,189,181,175,94,94,329,104,28,28,4,94,4,4,4,4,3,12,2,2,2,8,8,1,2024-01-07 07:36:00,0
5582,5584,5584,5584,2023,96,416,96,204,2023,212,96,196,181,179,96,96,416,212,27,27,0,96,3,3,3,3,3,4,2,2,2,15,15,0,2024-01-07 07:38:00,0
5571,5571,5571,5571,2018,88,339,88,218,2018,121,88,203,195,193,88,88,339,121,32,32,0,88,8,8,8,8,8,4,2,2,2,8,8,0,2024-01-07 07:40:00,0
5563,5563,5563,5563,2006,93,355,93,216,2006,139,93,199,189,185,93,93,355,139,27,27,4,93,3,3,3,3,3,8,2,2,2,10,10,0,2024-01-07 07:42:00,0
5597,5597,5597,5597,2024,94,325,94,210,2024,115,94,201,192,191,94,94,325,115,28,28,0,94,4,4,4,4,4,2,2,2,2,9,9,0,2024-01-07 07:44:00,0
5482,5519,5481,5481,2008,89,311,89,203,2008,108,89,198,192,187,89,89,311,108,31,31,4,89,7,7,7,7,7,10,2,2,2,6,6,0,2024-01-07 07:46:00,0
5565,5565,5565,5565,2015,97,320,97,206,2015,114,97,193,183,180,97,97,320,114,28,28,0,97,4,4,4,4,3,6,2,2,2,10,10,1,2024-01-07 07:48:00,0
5581,5577,5577,5577,2033,101,317,101,225,2033,92,101,184,177,174,101,101,317,92,28,28,0,101,4,4,4,4,4,6,2,2,2,7,7,0,2024-01-07 07:50:00,0
5596,5601,5601,5601,2027,90,331,90,208,2027,123,90,210,199,196,90,90,331,123,28,28,2,90,4,4,4,4,4,6,2,2,2,11,11,0,2024-01-07 07:52:00,0
5579,5578,5578,5578,2022,84,353,84,228,2022,125,84,199,192,186,84,84,353,125,31,31,0,84,7,7,7,7,7,12,2,2,2,7,7,0,2024-01-07 07:54:00,0
5614,5615,5615,5615,2029,93,355,93,215,2029,140,93,194,185,183,93,93,355,140,28,28,3,93,4,4,4,4,4,4,2,2,2,9,9,0,2024-01-07 07:56:00,0
5621,5640,5620,5620,2033,91,456,91,210,2033,246,91,207,201,198,91,91,456,246,28,28,1,91,4,4,4,4,4,6,2,2,2,6,6,0,2024-01-07 07:58:00,0
5562,5582,5563,5563,2021,84,328,84,215,2021,113,84,208,193,190,84,84,328,113,28,28,0,84,4,4,4,4,3,6,2,2,2,15,15,1,2024-01-07 08:00:00,0
5550,5550,5550,5550,2002,93,530,93,216,2002,314,93,218,202,200,93,93,530,314,31,31,4,93,7,7,7,7,7,4,2,2,2,16,16,0,2024-01-07 08:02:00,0
5579,5579,5579,5579,2024,90,334,90,207,2024,127,90,194,188,186,90,90,334,127,27,27,0,90,3,3,3,3,3,4,2,2,2,6,6,0,2024-01-07 08:04:00,0
5614,5614,5614,5614,2031,87,337,87,217,2031,120,87,197,185,182,87,87,337,120,28,28,0,87,4,4,4,4,3,6,2,2,2,12,12,1,2024-01-07 08:06:00,0
5607,5607,5607,5607,2025,97,336,97,224,2025,112,97,203,191,189,97,97,336,112,32,32,2,97,8,8,8,8,8,4,2,2,2,12,12,0,2024-01-07 08:08:00,0
5546,5546,5546,5546,2016,94,321,94,209,2016,112,94,197,183,179,94,94,321,112,27,27,0,94,3,3,3,3,3,8,2,2,2,14,14,0,2024-01-07 08:10:00,0
5595,5595,5595,5595,2025,84,345,84,219,2025,126,84,210,197,189,84,84,345,126,28,28,0,84,4,4,4,4,4,16,2,2,2,13,13,0,2024-01-07 08:12:00,0
5590,5590,5590,5590,2035,91,322,91,208,2035,114,91,192,188,188,91,91,322,114,28,28,0,91,4,4,4,4,4,0,2,2,2,4,4,0,2024-01-07 08:14:00,0
5563,5563,5563,5563,2035,92,312,92,217,2035,95,92,193,189,187,92,92,312,95,31,31,0,92,7,7,7,7,6,4,2,2,2,4,4,1,2024-01-07 08:16:00,0
5620,5620,5620,5620,2025,92,346,92,229,2025,117,92,200,194,192,92,92,346,117,28,28,3,92,4,4,4,4,4,4,2,2,2,6,6,0,2024-01-07 08:18:00,0
5586,5585,5585,5585,2022,93,333,93,206,2022,127,93,188,176,174,93,93,333,127,28,28,0,93,4,4,4,4,3,4,2,2,2,12,12,1,2024-01-07 08:20:00,0
5598,5597,5597,5597,2008,95,441,95,218,2008,223,95,205,198,198,95,95,441,223,27,27,4,95,3,3,3,3,3,0,2,2,2,7,7,0,2024-01-07 08:22:00,0
5560,5561,5561,5561,2018,90,317,90,212,2018,105,90,204,193,190,90,90,317,105,32,32,0,90,8,8,8,8,8,6,2,2,2,11,11,0,2024-01-07 08:24:00,0
5544,5545,5545,5545,2012,90,320,90,209,2012,111,90,200,189,186,90,90,320,111,27,27,0,90,3,3,3,3,3,6,2,2,2,11,11,0,2024-01-07 08:26:00,0
5578,5576,5576,5576,2029,89,322,89,213,2029,109,89,195,184,180,89,89,322,109,28,28,4,89,4,4,4,4,4,8,2,2,2,11,11,0,2024-01-07 08:28:00,0
5594,5595,5595,5595,2026,87,348,87,227,2026,121,87,190,180,177,87,87,348,121,31,31,0,87,7,7,7,7,7,6,2,2,2,10,10,0,2024-01-07 08:30:00,0
5574,5575,5575,5575,2017,89,436,89,210,2017,226,89,199,189,188,89,89,436,226,28,28,3,89,4,4,4,4,3,2,2,2,2,10,10,1,2024-01-07 08:32:00,0
5564,5564,5564,5564,2010,97,339,97,220,2010,119,97,206,194,192,97,97,339,119,27,27,1,97,4,4,4,4,4,4,2,2,2,12,12,0,2024-01-07 08:34:00,0
5582,5582,5582,5582,2028,108,308,108,208,2028,100,108,198,188,187,108,108,308,100,28,28,0,108,4,4,4,4,3,2,2,2,2,10,10,1,2024-01-07 08:36:00,0
5579,5579,5579,5579,2027,91,434,91,224,2027,210,91,198,190,189,91,91,434,210,31,31,4,91,7,7,7,7,7,2,2,2,2,8,8,0,2024-01-07 08:38:00,0
5637,5637,5637,5637,2038,88,338,88,216,2038,122,88,203,196,192,88,88,338,122,28,28,0,88,4,4,4,4,4,8,2,2,2,7,7,0,2024-01-07 08:40:00,0
5602,5602,5602,5602,2020,101,430,101,215,2020,215,101,210,197,193,101,101,430,215,27,27,0,101,3,3,3,3,3,8,2,2,2,13,13,0,2024-01-07 08:42:00,0
5601,5600,5600,5600,2023,95,342,95,217,2023,125,95,196,191,191,95,95,342,125,32,32,4,95,8,8,8,8,8,0,2,2,2,5,5,0,2024-01-07 08:44:00,0
5578,5579,5579,5579,2028,89,324,89,214,2028,110,89,195,185,184,89,89,324,110,27,27,0,89,3,3,3,3,3,2,2,2,2,10,10,0,2024-01-07 08:46:00,0
5564,5564,5564,5564,2022,82,316,82,207,2022,109,82,201,198,197,82,82,316,109,28,28,0,82,4,4,4,4,3,2,2,2,2,3,3,1,2024-01-07 08:48:00,0
5578,5578,5578,5578,2017,93,337,93,220,2017,117,93,200,192,190,93,93,337,117,28,28,0,93,4,4,4,4,4,4,2,2,2,8,8,0,2024-01-07 08:50:00,0
5557,5557,5557,5557,2025,97,309,97,213,2025,96,97,188,184,179,97,97,309,96,31,31,1,97,7,7,7,7,7,10,2,2,2,4,4,0,2024-01-07 08:52:00,0
5621,5622,5621,5621,2032,94,332,94,218,2032,114,94,201,197,193,94,94,332,114,28,28,2,94,4,4,4,4,3,8,2,2,2,4,4,1,2024-01-07 08:54:00,0
5573,5573,5573,5573,2007,97,354,97,225,2007,129,97,188,178,176,97,97,354,129,28,28,0,97,4,4,4,4,4,4,2,2,2,10,10,0,2024-01-07 08:56:00,0
5607,5606,5606,5606,2026,88,347,88,226,2026,121,88,211,197,196,88,88,347,121,28,28,4,88,4,4,4,4,4,2,2,2,2,14,14,0,2024-01-07 08:58:00,0
5590,5591,5591,5591,2024,91,328,91,216,2024,112,91,195,190,185,91,91,328,112,31,31,0,91,7,7,7,7,7,10,2,2,2,5,5,0,2024-01-07 09:00:00,0
5606,5606,5606,5606,2023,97,434,97,209,2023,225,97,209,192,186,97,97,434,225,28,28,0,97,4,4,4,4,4,12,2,2,2,17,17,0,2024-01-07 09:02:00,0
5575,5574,5574,5574,2015,94,331,94,221,2015,110,94,198,191,190,94,94,331,110,28,28,4,94,4,4,4,4,3,2,2,2,2,7,7,1,2024-01-07 09:04:00,0
5586,5586,5586,5586,2028,92,328,92,209,2028,119,92,197,185,184,92,92,328,119,31,31,0,92,7,7,7,7,7,2,2,2,2,12,12,0,2024-01-07 09:06:00,0
5616,5616,5616,5616,2032,89,345,89,222,2032,123,89,207,196,193,89,89,345,123,27,27,1,89,3,3,3,3,3,6,2,2,2,11,11,0,2024-01-07 09:08:00,0
5560,5561,5561,5561,2019,95,344,95,218,2019,126,95,191,178,175,95,95,344,126,28,28,1,95,4,4,4,4,3,6,2,2,2,13,13,1,2024-01-07 09:10:00,0
5565,5566,5565,5565,2027,84,416,84,215,2027,201,84,193,188,184,84,84,416,201,28,28,0,84,4,4,4,4,4,8,2,2,2,5,5,0,2024-01-07 09:12:00,0
5570,5569,5569,5569,2022,101,349,101,223,2022,126,101,189,181,180,101,101,349,126,31,31,4,101,7,7,7,7,7,2,2,2,2,8,8,0,2024-01-07 09:14:00,0
5609,5608,5608,5608,2034,93,320,93,210,2034,110,93,206,192,188,93,93,320,110,28,28,0,93,4,4,4,4,4,8,2,2,2,14,14,0,2024-01-07 09:16:00,0
5572,5571,5571,5571,2025,85,324,85,217,2025,107,85,208,198,193,85,85,324,107,28,28,0,85,4,4,4,4,4,10,2,2,2,10,10,0,2024-01-07 09:18:00,0
5567,5570,5570,5570,2025,94,317,94,204,2025,113,94,203,194,192,94,94,317,113,28,28,2,94,4,4,4,4,3,4,2,2,2,9,9,1,2024-01-07 09:20:00,0
5551,5551,5551,5551,1998,104,337,104,202,1998,135,104,205,196,191,104,104,337,135,31,31,0,104,7,7,7,7,7,10,2,2,2,9,9,0,2024-01-07 09:22:00,0
5607,5605,5605,5605,2039,90,328,90,218,2039,110,90,192,184,182,90,90,328,110,27,27,2,90,3,3,3,3,3,4,2,2,2,8,8,0,2024-01-07 09:24:00,0
5628,5630,5630,5630,2036,98,336,98,227,2036,109,98,204,195,191,98,98,336,109,28,28,0,98,4,4,4,4,3,8,2,2,2,9,9,1,2024-01-07 09:26:00,0
5573,5573,5573,5573,2022,87,319,87,215,2022,104,87,203,191,189,87,87,319,104,32,32,2,87,8,8,8,8,8,4,2,2,2,12,12,0,2024-01-07 09:28:00,0
5582,5580,5580,5580,2031,89,337,89,208,2031,129,89,188,177,176,89,89,337,129,27,27,4,89,3,3,3,3,3,2,2,2,2,11,11,0,2024-01-07 09:30:00,0
5557,5559,5559,5559,2027,99,315,99,215,2027,100,99,189,184,179,99,99,315,100,28,28,0,99,4,4,4,4,4,10,2,2,2,5,5,0,2024-01-07 09:32:00,0
5583,5583,5583,5583,2029,85,338,85,219,2029,119,85,193,180,175,85,85,338,119,28,28,4,85,4,4,4,4,4,10,2,2,2,13,13,0,2024-01-07 09:34:00,0
5589,5588,5588,5588,2022,97,322,97,213,2022,109,97,194,180,176,97,97,322,109,31,31,0,97,7,7,7,7,6,8,2,2,2,14,14,1,2024-01-07 09:36:00,0
5543,5543,5543,5543,2024,89,318,89,213,2024,105,89,191,184,180,89,89,318,105,28,28,0,89,4,4,4,4,4,8,2,2,2,7,7,0,2024-01-07 09:38:00,0
5584,5585,5585,5585,2039,78,320,78,212,2039,108,78,195,183,181,78,78,320,108,28,28,0,78,4,4,4,4,3,4,2,2,2,12,12,1,2024-01-07 09:40:00,0
5593,5592,5592,5592,2025,93,428,93,212,2025,216,93,212,196,194,93,93,428,216,31,31,0,93,7,7,7,7,7,4,2,2,2,16,16,0,2024-01-07 09:42:00,0
5574,5575,5575,5575,2007,100,334,100,210,2007,124,100,204,196,192,100,100,334,124,28,28,1,100,4,4,4,4,4,8,2,2,2,8,8,0,2024-01-07 09:44:00,0
5538,5538,5538,5538,2022,86,310,86,210,2022,100,86,198,190,188,86,86,310,100,27,27,4,86,3,3,3,3,3,4,2,2,2,8,8,0,2024-01-07 09:46:00,0
5595,5594,5594,5594,2026,81,353,81,220,2026,133,81,199,193,189,81,81,353,133,28,28,0,81,4,4,4,4,4,8,2,2,2,6,6,0,2024-01-07 09:48:00,0
5560,5561,5561,5561,2023,88,364,88,220,2023,144,88,202,191,190,88,88,364,93,32,32,4,88,8,8,7,7,7,2,2,2,2,11,11,0,2024-01-07 09:50:00,52
5605,5604,5604,5604,2024,94,321,94,210,2024,111,94,200,193,193,94,94,321,111,28,28,0,94,4,4,4,4,4,0,2,2,2,7,7,0,2024-01-07 09:52:00,0
5548,5546,5546,5546,2011,87,334,87,217,2011,117,87,195,186,185,87,87,334,117,28,28,0,87,4,4,4,4,4,2,2,2,2,9,9,0,2024-01-07 09:54:00,0
5593,5595,5595,5595,2023,93,338,93,218,2023,120,93,205,197,193,93,93,338,120,27,27,4,93,3,3,3,3,3,8,2,2,2,8,8,0,2024-01-07 09:56:00,0
5574,5574,5574,5574,2024,97,339,97,216,2024,123,97,202,195,190,97,97,339,123,32,32,0,97,8,8,8,8,8,10,2,2,2,7,7,0,2024-01-07 09:58:00,0
5593,5592,5592,5592,2021,102,329,102,214,2021,115,102,199,188,186,102,102,329,115,27,27,2,102,3,3,3,3,3,4,2,2,2,11,11,0,2024-01-07 10:00:00,0
5609,5609,5609,5609,2027,90,544,90,206,2027,338,90,193,183,181,90,90,544,338,28,28,2,90,4,4,4,4,3,4,2,2,2,10,10,1,2024-01-07 10:02:00,0
5595,5597,5597,5597,2023,97,326,97,216,2023,110,97,199,191,188,97,97,326,110,31,31,0,97,7,7,7,7,7,6,2,2,2,8,8,0,2024-01-07 10:04:00,0
5577,5577,5577,5577,2011,95,352,95,215,2011,137,95,202,191,189,95,95,352,137,28,28,4,95,4,4,4,4,3,4,2,2,2,11,11,1,2024-01-07 10:06:00,0
5551,5548,5548,5548,2024,88,322,88,213,2024,109,88,190,186,181,88,88,322,109,28,28,0,88,4,4,4,4,4,10,2,2,2,4,4,0,2024-01-07 10:08:00,0
5606,5609,5609,5609,2021,93,341,93,206,2021,135,93,201,192,190,93,93,341,135,28,28,0,93,4,4,4,4,4,4,2,2,2,9,9,0,2024-01-07 10:10:00,0
5590,5589,5589,5589,2022,88,349,88,222,2022,127,88,187,182,178,88,88,349,127,31,31,2,88,7,7,7,7,7,8,2,2,2,5,5,0,2024-01-07 10:12:00,0
5622,5622,5622,5622,2031,106,323,106,208,2031,115,106,207,199,197,106,106,323,115,28,28,0,106,4,4,4,4,4,4,2,2,2,8,8,0,2024-01-07 10:14:00,0
5608,5609,5609,5609,2023,93,348,93,218,2023,130,93,193,187,185,93,93,348,130,28,28,4,93,4,4,4,4,3,4,2,2,2,6,6,1,2024-01-07 10:16:00,0
5620,5618,5618,5618,2031,89,359,89,209,2031,150,89,208,199,198,89,89,359,150,27,27,0,89,3,3,3,3,3,2,2,2,2,9,9,0,2024-01-07 10:18:00,0
5629,5631,5631,5631,2025,98,359,98,210,2025,149,98,203,191,190,98,98,359,149,31,31,0,98,7,7,7,7,7,2,2,2,2,12,12,0,2024-01-07 10:20:00,0
5595,5595,5595,5595,2021,100,341,100,213,2021,128,100,205,191,188,100,100,341,128,28,28,2,100,4,4,4,4,3,6,2,2,2,14,14,1,2024-01-07 10:22:00,0
5559,5558,5558,5558,2027,91,309,91,207,2027,102,91,196,187,184,91,91,309,102,28,28,0,91,4,4,4,4,4,6,2,2,2,9,9,0,2024-01-07 10:24:00,0
5565,5566,5566,5566,2019,79,334,79,210,2019,124,79,191,185,181,79,79,334,124,31,31,4,79,7,7,7,7,7,8,2,2,2,6,6,0,2024-01-07 10:26:00,0
5593,5592,5592,5592,2028,86,429,86,219,2028,210,86,206,193,191,86,86,429,210,28,28,0,86,4,4,4,4,4,4,2,2,2,13,13,0,2024-01-07 10:28:00,0
5518,5519,5519,5519,2007,92,326,92,207,2007,119,92,200,189,186,92,92,326,119,28,28,0,92,4,4,4,4,4,6,2,2,2,11,11,0,2024-01-07 10:30:00,0
5608,5607,5607,5607,2027,105,338,105,211,2027,127,105,197,189,185,105,105,338,127,28,28,2,105,4,4,4,4,3,8,2,2,2,8,8,1,2024-01-07 10:32:00,0
5521,5522,5522,5522,2025,94,296,94,210,2025,86,94,193,185,178,94,94,296,86,31,31,0,94,7,7,7,7,7,14,2,2,2,8,8,0,2024-01-07 10:34:00,0
5615,5615,5615,5615,2033,96,340,96,218,2033,122,96,202,192,189,96,96,340,122,27,27,0,96,3,3,3,3,3,6,2,2,2,10,10,0,2024-01-07 10:36:00,0
5597,5596,5596,5596,2030,103,418,102,214,2030,204,102,207,193,192,102,102,418,204,28,28,0,102,4,4,4,4,3,2,2,2,2,14,14,1,2024-01-07 10:38:00,0
5596,5597,5597,5597,2033,89,331,90,218,2033,113,90,211,201,198,90,90,331,113,32,32,1,90,8,8,8,8,8,6,2,2,2,10,10,0,2024-01-07 10:40:00,0
5567,5566,5566,5566,2011,93,326,93,212,2011,114,93,200,191,189,93,93,326,114,27,27,4,93,3,3,3,3,3,4,2,2,2,9,9,0,2024-01-07 10:42:00,0
5570,5571,5571,5571,2015,90,324,90,214,2015,110,90,202,193,189,90,90,324,110,28,28,0,90,4,4,4,4,4,8,2,2,2,9,9,0,2024-01-07 10:44:00,0
5603,5603,5603,5603,2019,101,355,101,224,2019,131,101,196,188,187,101,101,355,131,28,28,0,101,4,4,4,4,4,2,2,2,2,8,8,0,2024-01-07 10:46:00,0
5605,5625,5605,5605,2026,93,337,93,217,2026,120,93,207,195,191,93,93,337,120,31,31,4,93,7,7,7,7,6,8,2,2,2,12,12,1,2024-01-07 10:48:00,0
5591,5589,5589,5589,2033,101,319,101,214,2033,105,101,207,194,191,101,101,319,105,28,28,0,101,4,4,4,4,4,6,2,2,2,13,13,0,2024-01-07 10:50:00,0
5580,5582,5582,5582,2030,91,317,91,204,2030,113,91,199,189,187,91,91,317,113,28,28,4,91,4,4,4,4,4,4,2,2,2,10,10,0,2024-01-07 10:52:00,0
5520,5518,5518,5518,2007,88,311,88,213,2007,98,88,187,180,176,88,88,311,98,28,28,0,88,4,4,4,4,4,8,2,2,2,7,7,0,2024-01-07 10:54:00,0
5591,5593,5593,5593,2009,88,369,88,221,2009,148,88,201,193,190,88,88,369,148,33,33,0,88,8,7,7,7,7,6,2,2,2,8,8,0,2024-01-07 10:56:00,3
5606,5606,5606,5606,2016,96,365,96,214,2016,151,96,201,191,184,96,96,365,151,28,28,0,96,4,4,4,4,4,14,2,2,2,10,10,0,2024-01-07 10:58:00,0
5537,5536,5536,5536,2015,103,317,103,205,2015,112,103,194,187,186,103,103,317,112,28,28,1,103,4,4,4,4,3,2,2,2,2,7,7,1,2024-01-07 11:00:00,0
5568,5569,5567,5567,1999,86,666,86,218,1999,448,86,207,201,193,86,86,666,448,31,31,3,86,7,7,7,7,7,16,2,2,2,6,6,0,2024-01-07 11:02:00,0
5549,5550,5550,5550,2021,96,323,96,214,2021,109,96,189,187,185,96,96,323,109,27,27,1,96,3,3,3,3,3,4,2,2,2,2,2,0,2024-01-07 11:04:00,0
5600,5601,5601,5601,2021,81,365,81,216,2021,149,81,190,184,184,81,81,365,149,28,28,0,81,4,4,4,4,3,0,2,2,2,6,6,1,2024-01-07 11:06:00,0
5608,5607,5607,5607,2014,90,361,90,216,2014,145,90,205,194,191,90,90,361,145,28,28,0,90,4,4,4,4,4,6,2,2,2,11,11,0,2024-01-07 11:08:00,0
5576,5577,5577,5577,2017,86,344,86,217,2017,127,86,196,187,185,86,86,344,127,31,31,0,86,7,7,7,7,7,4,2,2,2,9,9,0,2024-01-07 11:10:00,0
5588,5586,5586,5586,2018,93,329,93,209,2018,120,93,195,185,183,93,93,329,120,28,28,2,93,4,4,4,4,4,4,2,2,2,10,10,0,2024-01-07 11:12:00,0
5620,5622,5622,5622,2035,89,370,89,217,2035,153,89,196,189,186,89,89,370,153,28,28,1,89,4,4,4,4,4,6,2,2,2,7,7,0,2024-01-07 11:14:00,0
5597,5618,5597,5597,2034,89,344,89,213,2034,131,89,197,190,187,89,89,344,131,28,28,0,89,4,4,4,4,3,6,2,2,2,7,7,1,2024-01-07 11:16:00,0
5543,5542,5542,5542,2008,85,338,85,217,2008,121,85,198,194,191,85,85,338,121,30,30,2,85,7,7,7,7,7,6,2,2,2,4,4,0,2024-01-07 11:18:00,0
5573,5574,5574,5574,2021,95,308,95,203,2021,105,95,203,188,185,95,95,308,105,27,27,0,95,3,3,3,3,3,6,2,2,2,15,15,0,2024-01-07 11:20:00,0
5562,5560,5560,5560,2012,88,329,88,212,2012,117,88,202,196,193,88,88,329,117,28,28,0,88,4,4,4,4,3,6,2,2,2,6,6,1,2024-01-07 11:22:00,0
5592,5593,5593,5593,2030,88,340,88,234,2030,106,88,200,189,186,88,88,340,106,32,32,4,88,8,8,8,8,8,6,2,2,2,11,11,0,2024-01-07 11:24:00,0
5648,5648,5648,5648,2026,100,346,100,211,2026,135,100,195,188,184,100,100,346,135,27,27,0,100,3,3,3,3,3,8,2,2,2,7,7,0,2024-01-07 11:26:00,0
5561,5561,5561,5561,2022,94,315,94,204,2022,111,94,202,192,187,94,94,315,111,28,28,4,94,4,4,4,4,4,10,2,2,2,10,10,0,2024-01-07 11:28:00,0
5595,5596,5596,5596,2028,97,312,97,210,2028,102,97,187,181,181,97,97,312,102,28,28,0,97,4,4,4,4,4,0,2,2,2,6,6,0,2024-01-07 11:30:00,0
5604,5604,5604,5604,2022,92,354,92,222,2022,132,92,209,196,193,92,92,354,132,31,31,0,92,7,7,7,7,6,6,2,2,2,13,13,1,2024-01-07 11:32:00,0
5576,5576,5576,5576,2025,96,315,96,215,2025,100,96,214,200,200,96,96,315,100,28,28,4,96,4,4,4,4,4,0,2,2,2,14,14,0,2024-01-07 11:34:00,0
5583,5581,5581,5581,2023,88,336,88,217,2023,119,88,195,184,183,88,88,336,119,28,28,0,88,4,4,4,4,3,2,2,2,2,11,11,1,2024-01-07 11:36:00,0
5598,5599,5599,5599,2029,97,344,96,221,2029,123,96,189,182,180,96,96,344,123,27,27,4,96,3,3,3,3,3,4,2,2,2,7,7,0,2024-01-07 11:38:00,0
5596,5598,5597,5597,2031,95,330,96,219,2031,111,96,204,189,186,96,96,330,111,32,32,0,96,8,8,8,8,8,6,2,2,2,15,15,0,2024-01-07 11:40:00,0
5564,5564,5564,5564,2003,94,416,94,198,2003,218,94,206,192,190,94,94,416,218,27,27,0,94,3,3,3,3,3,4,2,2,2,14,14,0,2024-01-07 11:42:00,0
5610,5610,5610,5610,2039,91,330,91,218,2039,112,91,191,183,182,91,91,330,112,28,28,2,91,4,4,4,4,4,2,2,2,2,8,8,0,2024-01-07 11:44:00,0
5597,5597,5597,5597,2026,82,364,82,212,2026,152,82,202,192,190,82,82,364,152,31,31,0,82,7,7,7,7,7,4,2,2,2,10,10,0,2024-01-07 11:46:00,0
5632,5631,5631,5631,2030,96,441,96,212,2030,229,96,202,192,190,96,96,441,229,28,28,2,96,4,4,4,4,3,4,2,2,2,10,10,1,2024-01-07 11:48:00,0
5588,5587,5587,5587,2023,90,335,90,212,2023,123,90,197,187,186,90,90,335,123,28,28,2,90,4,4,4,4,4,2,2,2,2,10,10,0,2024-01-07 11:50:00,0
5547,5546,5546,5546,2013,89,313,89,208,2013,105,89,196,187,183,89,89,313,105,28,28,0,89,4,4,4,4,4,8,2,2,2,9,9,0,2024-01-07 11:52:00,0
5646,5647,5647,5647,2024,105,362,105,231,2024,131,105,207,197,195,105,105,362,131,31,31,4,105,7,7,7,7,7,4,2,2,2,10,10,0,2024-01-07 11:54:00,0
5594,5594,5594,5594,2025,92,331,92,212,2025,119,92,200,189,186,92,92,331,119,28,28,0,92,4,4,4,4,4,6,2,2,2,11,11,0,2024-01-07 11:56:00,0
5593,5594,5594,5594,2027,82,440,82,213,2027,227,82,196,188,183,82,82,440,227,28,28,0,82,4,4,4,4,4,10,2,2,2,8,8,0,2024-01-07 11:58:00,0
5596,5596,5596,5596,2014,93,357,93,210,2014,147,93,203,197,193,93,93,357,147,31,31,4,93,7,7,7,7,6,8,2,2,2,6,6,1,2024-01-07 12:00:00,0
5626,5626,5626,5626,2019,96,758,96,210,2019,548,96,204,189,189,96,96,758,548,28,28,0,96,4,4,4,4,4,0,2,2,2,15,15,0,2024-01-07 12:02:00,0
5580,5581,5581,5581,2033,92,344,92,219,2033,125,92,189,184,183,92,92,344,125,27,27,0,92,3,3,3,3,3,2,2,2,2,5,5,0,2024-01-07 12:04:00,0
5535,5535,5535,5535,2007,97,335,97,209,2007,126,97,193,177,177,97,97,335,126,28,28,0,97,4,4,4,4,3,0,2,2,2,16,16,1,2024-01-07 12:06:00,0
5590,5587,5587,5587,2015,83,457,83,212,2015,245,83,206,196,195,83,83,457,245,32,32,0,83,8,8,8,8,8,2,2,2,2,10,10,0,2024-01-07 12:08:00,0
5599,5601,5601,5601,2022,99,348,99,216,2022,132,99,182,179,177,99,99,348,132,27,27,5,99,3,3,3,3,3,4,2,2,2,3,3,0,2024-01-07 12:10:00,0
5597,5598,5598,5598,2027,94,355,94,212,2027,143,94,192,186,181,94,94,355,143,28,28,0,94,4,4,4,4,4,10,2,2,2,6,6,0,2024-01-07 12:12:00,0
5624,5624,5624,5624,2034,93,338,93,224,2034,114,93,200,192,188,93,93,338,114,28,28,2,93,4,4,4,4,4,8,2,2,2,8,8,0,2024-01-07 12:14:00,0
5624,5624,5624,5624,2035,100,334,100,210,2035,124,100,199,187,183,100,100,334,124,31,31,2,100,7,7,7,7,6,8,2,2,2,12,12,1,2024-01-07 12:16:00,0
5587,5586,5586,5586,2026,99,315,99,211,2026,104,99,193,187,185,99,99,315,104,28,28,0,99,4,4,4,4,4,4,2,2,2,6,6,0,2024-01-07 12:18:00,0
5594,5592,5592,5592,2021,95,345,95,216,2021,129,95,207,194,190,95,95,345,129,28,28,2,95,4,4,4,4,3,8,2,2,2,13,13,1,2024-01-07 12:20:00,0
5566,5567,5567,5567,2005,89,326,89,217,2005,109,89,201,190,187,89,89,326,109,31,31,0,89,7,7,7,7,7,6,2,2,2,11,11,0,2024-01-07 12:22:00,0
5620,5622,5622,5622,2022,95,375,95,222,2022,153,95,202,192,189,95,95,375,153,28,28,0,95,4,4,4,4,4,6,2,2,2,10,10,0,2024-01-07 12:24:00,0
5627,5626,5626,5626,2033,91,350,91,211,2033,139,91,195,185,183,91,91,350,139,27,27,4,91,3,3,3,3,3,4,2,2,2,10,10,0,2024-01-07 12:26:00,0
5599,5599,5599,5599,2031,89,332,89,205,2031,127,89,214,199,194,89,89,332,127,28,28,0,89,4,4,4,4,4,10,2,2,2,15,15,0,2024-01-07 12:28:00,0
5555,5556,5556,5556,2008,94,326,94,207,2008,119,94,197,193,188,94,94,326,119,31,31,2,94,7,7,7,7,7,10,2,2,2,4,4,0,2024-01-07 12:30:00,0
5666,5666,5666,5666,2034,92,449,92,224,2034,225,92,218,209,204,92,92,449,225,28,28,0,92,4,4,4,4,3,10,2,2,2,9,9,1,2024-01-07 12:32:00,0
5581,5581,5581,5581,2030,91,317,91,202,2030,115,91,202,194,190,91,91,317,115,28,28,2,91,4,4,4,4,4,8,2,2,2,8,8,0,2024-01-07 12:34:00,0
5595,5594,5594,5594,2023,100,349,100,202,2023,147,100,198,188,185,100,100,349,147,28,28,4,100,4,4,4,4,3,6,2,2,2,10,10,1,2024-01-07 12:36:00,0
5595,5596,5596,5596,2027,90,447,90,217,2027,230,90,185,178,176,90,90,447,230,31,31,0,90,7,7,7,7,7,4,2,2,2,7,7,0,2024-01-07 12:38:00,0
5582,5582,5582,5582,2027,89,326,89,215,2027,111,89,201,196,193,89,89,326,111,28,28,0,89,4,4,4,4,4,6,2,2,2,5,5,0,2024-01-07 12:40:00,0
5618,5617,5616,5616,2024,96,350,96,224,2024,126,96,189,179,176,96,96,350,126,27,27,0,96,3,3,3,3,3,6,2,2,2,10,10,0,2024-01-07 12:42:00,0
5586,5588,5588,5588,2031,87,311,87,215,2031,96,87,206,195,192,87,87,311,96,32,32,0,87,8,8,8,8,8,6,2,2,2,11,11,0,2024-01-07 12:44:00,0
5605,5604,5602,5602,2023,95,325,95,213,2023,112,95,202,189,187,95,95,325,112,27,27,3,95,3,3,3,3,3,4,2,2,2,13,13,0,2024-01-07 12:46:00,0
5575,5578,5578,5578,2024,94,345,94,217,2024,128,94,199,189,188,94,94,345,128,28,28,0,94,4,4,4,4,3,2,2,2,2,10,10,1,2024-01-07 12:48:00,0
5655,5654,5654,5654,2024,98,356,98,217,2024,139,98,202,196,194,98,98,356,139,28,28,0,98,4,4,4,4,4,4,2,2,2,6,6,0,2024-01-07 12:50:00,0
5615,5615,5615,5615,2034,96,339,96,222,2034,117,96,201,192,191,96,96,339,117,31,31,2,96,7,7,7,7,7,2,2,2,2,9,9,0,2024-01-07 12:52:00,0
5544,5545,5545,5545,2006,97,315,97,207,2006,108,97,183,175,174,97,97,315,108,28,28,0,97,4,4,4,4,3,2,2,2,2,8,8,1,2024-01-07 12:54:00,0
5596,5596,5596,5596,2028,98,333,98,214,2028,119,98,210,203,202,98,98,333,119,28,28,4,98,4,4,4,4,4,2,2,2,2,7,7,0,2024-01-07 12:56:00,0
5603,5602,5602,5602,2019,94,324,94,213,2019,111,94,204,197,193,94,94,324,111,31,31,0,94,7,7,7,7,6,8,2,2,2,7,7,1,2024-01-07 12:58:00,0
5583,5584,5584,5584,2033,94,320,94,211,2033,109,94,205,198,192,94,94,320,109,28,28,0,94,4,4,4,4,4,12,2,2,2,7,7,0,2024-01-07 13:00:00,0
5611,5630,5610,5610,2020,94,556,94,221,2020,335,94,207,196,191,94,94,556,335,28,28,0,94,4,4,4,4,4,10,2,2,2,11,11,0,2024-01-07 13:02:00,0
5571,5572,5572,5572,2029,97,407,97,212,2029,195,97,204,197,195,97,97,407,195,27,27,0,97,3,3,3,3,3,4,2,2,2,7,7,0,2024-01-07 13:04:00,0
5644,5643,5643,5643,2024,93,376,93,227,2024,149,93,198,185,185,93,93,376,149,32,32,5,93,8,8,8,8,8,0,2,2,2,13,13,0,2024-01-07 13:06:00,0
5601,5601,5601,5601,2024,97,333,97,218,2024,115,97,199,191,188,97,97,333,115,27,27,0,97,3,3,3,3,3,6,2,2,2,8,8,0,2024-01-07 13:08:00,0
5575,5576,5576,5576,2021,91,350,91,222,2021,128,91,191,177,176,91,91,350,128,28,28,0,91,4,4,4,4,3,2,2,2,2,14,14,1,2024-01-07 13:10:00,0
5557,5556,5556,5556,2027,88,309,88,207,2027,102,88,197,183,180,88,88,309,102,28,28,4,88,4,4,4,4,4,6,2,2,2,14,14,0,2024-01-07 13:12:00,0
5622,5623,5623,5623,2024,98,358,98,223,2024,135,98,200,188,187,98,98,358,135,31,31,0,98,7,7,7,7,6,2,2,2,2,12,12,1,2024-01-07 13:14:00,0
5555,5554,5554,5554,2029,91,305,91,203,2029,102,91,193,186,182,91,91,305,102,28,28,0,91,4,4,4,4,4,8,2,2,2,7,7,0,2024-01-07 13:16:00,0
5536,5538,5536,5536,2010,91,411,91,204,2010,207,91,204,195,193,91,91,411,207,28,28,4,91,4,4,4,4,4,4,2,2,2,9,9,0,2024-01-07 13:18:00,0
5596,5597,5597,5597,2027,96,340,96,222,2027,118,96,189,180,176,96,96,340,118,31,31,0,96,7,7,7,7,7,8,2,2,2,9,9,0,2024-01-07 13:20:00,0
5604,5603,5603,5603,2023,92,452,92,207,2023,245,92,202,190,188,92,92,452,245,28,28,4,92,4,4,4,4,4,4,2,2,2,12,12,0,2024-01-07 13:22:00,0
5622,5622,5622,5622,2027,87,354,87,223,2027,131,87,197,190,188,87,87,354,131,27,27,0,87,3,3,3,3,3,4,2,2,2,7,7,0,2024-01-07 13:24:00,0
5589,5590,5590,5590,2024,91,343,91,225,2024,118,91,187,180,177,91,91,343,118,28,28,0,91,4,4,4,4,3,6,2,2,2,7,7,1,2024-01-07 13:26:00,0
5595,5595,5595,5595,2018,93,342,93,203,2018,139,93,213,201,200,93,93,342,139,31,31,0,93,7,7,7,7,7,2,2,2,2,12,12,0,2024-01-07 13:28:00,0
5607,5607,5607,5607,2031,96,324,96,214,2031,110,96,198,189,189,96,96,324,110,28,28,0,96,4,4,4,4,3,0,2,2,2,9,9,1,2024-01-07 13:30:00,0
5622,5621,5621,5621,2033,100,344,100,204,2033,140,100,213,196,193,100,100,344,140,28,28,3,100,4,4,4,4,4,6,2,2,2,17,17,0,2024-01-07 13:32:00,0
5645,5645,5645,5645,2036,109,351,109,223,2036,128,109,193,185,181,109,109,351,128,28,28,0,109,4,4,4,4,4,8,2,2,2,8,8,0,2024-01-07 13:34:00,0
5571,5572,5572,5572,2017,90,327,90,216,2017,111,90,191,183,179,90,90,327,111,31,31,0,90,7,7,7,7,7,8,2,2,2,8,8,0,2024-01-07 13:36:00,0
5615,5613,5613,5613,2021,98,339,98,219,2021,120,98,197,188,187,98,98,339,120,28,28,0,98,4,4,4,4,4,2,2,2,2,9,9,0,2024-01-07 13:38:00,0
5572,5574,5574,5574,2007,84,344,84,221,2007,123,84,204,192,189,84,84,344,123,28,28,0,84,4,4,4,4,3,6,2,2,2,12,12,1,2024-01-07 13:40:00,0
5587,5586,5586,5586,2015,85,355,85,225,2015,130,85,201,192,188,85,85,355,130,31,31,0,85,7,7,7,7,7,8,2,2,2,9,9,0,2024-01-07 13:42:00,0
5595,5596,5596,5596,2021,93,343,93,215,2021,128,93,197,189,182,93,93,343,128,27,27,1,93,3,3,3,3,3,14,2,2,2,8,8,0,2024-01-07 13:44:00,0
5568,5567,5567,5567,2024,86,334,86,216,2024,118,86,197,186,183,86,86,334,118,28,28,0,86,4,4,4,4,3,6,2,2,2,11,11,1,2024-01-07 13:46:00,0
5617,5618,5618,5618,2026,86,342,86,211,2026,131,86,215,199,196,86,86,342,131,28,28,2,86,4,4,4,4,4,6,2,2,2,16,16,0,2024-01-07 13:48:00,0
5587,5586,5586,5586,2027,89,379,89,227,2027,152,89,196,186,182,89,89,379,101,32,32,0,89,8,8,7,7,7,8,2,2,2,10,10,0,2024-01-07 13:50:00,52
5613,5614,5614,5614,2031,93,333,93,217,2031,116,93,217,202,196,93,93,333,116,28,28,0,93,4,4,4,4,4,12,2,2,2,15,15,0,2024-01-07 13:52:00,0
5564,5562,5563,5563,2026,81,315,81,207,2026,108,81,202,194,193,81,81,315,108,28,28,2,81,4,4,4,4,4,2,2,2,2,8,8,0,2024-01-07 13:54:00,0
5587,5586,5585,5585,2031,94,336,94,212,2031,124,94,182,177,176,94,94,336,124,31,31,0,94,7,7,7,7,7,2,2,2,2,5,5,0,2024-01-07 13:56:00,0
5587,5591,5590,5590,2020,104,347,104,215,2020,132,104,202,190,185,104,104,347,132,28,28,2,104,4,4,4,4,4,10,2,2,2,12,12,0,2024-01-07 13:58:00,0
5622,5622,5622,5622,2023,100,353,100,212,2023,141,100,198,188,184,100,100,353,141,27,27,0,100,3,3,3,3,3,8,2,2,2,10,10,0,2024-01-07 14:00:00,0
5671,5670,5670,5670,2018,97,597,97,222,2018,375,97,211,193,187,97,97,597,375,28,28,0,97,4,4,4,4,3,12,2,2,2,18,18,1,2024-01-07 14:02:00,0
5567,5568,5568,5568,2004,82,348,82,220,2004,128,82,210,199,197,82,82,348,128,30,30,4,82,7,7,7,7,7,4,2,2,2,11,11,0,2024-01-07 14:04:00,0
5580,5600,5579,5579,2026,97,320,97,214,2026,106,97,202,190,187,97,97,320,106,28,28,0,97,4,4,4,4,3,6,2,2,2,12,12,1,2024-01-07 14:06:00,0
5560,5560,5560,5560,2028,86,406,86,209,2028,197,86,196,188,188,86,86,406,197,28,28,3,86,4,4,4,4,4,0,2,2,2,8,8,0,2024-01-07 14:08:00,0
5584,5585,5585,5585,2018,93,341,93,208,2018,133,93,201,189,187,93,93,341,133,28,28,1,93,4,4,4,4,4,4,2,2,2,12,12,0,2024-01-07 14:10:00,0
5634,5633,5633,5633,2034,80,368,80,232,2034,136,80,193,186,185,80,80,368,136,31,31,0,80,7,7,7,7,7,2,2,2,2,7,7,0,2024-01-07 14:12:00,0
5588,5589,5589,5589,2037,86,325,86,215,2037,110,86,206,195,191,86,86,325,110,28,28,2,86,4,4,4,4,4,8,2,2,2,11,11,0,2024-01-07 14:14:00,0
5582,5579,5579,5579,2019,93,329,93,221,2019,108,93,187,180,179,93,93,329,108,28,28,0,93,4,4,4,4,3,2,2,2,2,7,7,1,2024-01-07 14:16:00,0
5567,5568,5568,5568,2028,90,322,90,215,2028,107,90,193,184,181,90,90,322,107,31,31,0,90,7,7,7,7,7,6,2,2,2,9,9,0,2024-01-07 14:18:00,0
5605,5605,5605,5605,2028,84,351,84,222,2028,129,84,198,187,186,84,84,351,129,27,27,6,84,3,3,3,3,3,3,2,2,2,11,11,0,2024-01-07 14:20:00,0
5535,5537,5537,5537,2003,99,340,99,224,2003,116,99,200,189,188,99,99,340,116,28,28,0,99,4,4,4,4,3,3,2,2,2,11,11,1,2024-01-07 14:22:00,0
5601,5601,5601,5601,2024,99,337,99,220,2024,117,99,208,195,192,99,99,337,117,29,29,2,99,4,4,4,4,4,9,2,2,2,13,13,0,2024-01-07 14:24:00,0
5578,5576,5576,5576,1998,94,371,94,212,1998,159,94,205,190,188,94,94,371,159,30,30,0,94,7,7,7,7,7,6,2,2,2,15,15,0,2024-01-07 14:26:00,0
5570,5572,5572,5572,2012,95,344,95,209,2012,135,95,201,188,185,95,95,344,135,28,28,0,95,4,4,4,4,3,9,2,2,2,13,13,1,2024-01-07 14:28:00,0
5608,5605,5605,5605,2012,101,352,101,219,2012,133,101,204,195,194,101,101,352,133,28,28,4,101,4,4,4,4,4,3,2,2,2,9,9,0,2024-01-07 14:30:00,0
5573,5576,5576,5576,2011,100,333,100,212,2011,121,100,196,187,184,100,100,333,121,28,28,0,100,4,4,4,4,4,9,2,2,2,9,9,0,2024-01-07 14:32:00,0
5578,5577,5577,5577,2014,98,337,98,207,2014,130,98,194,187,186,98,98,337,130,31,31,4,98,7,7,7,7,7,3,2,2,2,7,7,0,2024-01-07 14:34:00,0
5578,5579,5578,5578,2022,88,335,88,211,2022,124,88,200,190,186,88,88,335,124,28,28,0,88,4,4,4,4,4,12,2,2,2,10,10,0,2024-01-07 14:36:00,0
5569,5570,5570,5570,2026,86,323,86,212,2026,111,86,198,193,193,86,86,323,111,28,28,0,86,4,4,4,4,3,0,2,2,2,5,5,1,2024-01-07 14:38:00,0
5598,5597,5597,5597,2033,90,333,90,227,2033,106,90,208,199,194,90,90,333,106,31,31,2,90,7,7,7,7,7,15,2,2,2,9,9,0,2024-01-07 14:40:00,0
5590,5591,5591,5591,2029,93,327,93,203,2029,124,93,202,193,190,93,93,327,124,27,27,0,93,3,3,3,3,3,9,2,2,2,9,9,0,2024-01-07 14:42:00,0
5577,5576,5576,5576,2022,93,332,92,212,2022,120,92,204,194,191,92,92,332,120,28,28,0,92,4,4,4,4,3,9,2,2,2,10,10,1,2024-01-07 14:44:00,0
5590,5591,5591,5591,2023,92,347,93,217,2023,130,93,200,194,190,93,93,347,130,28,28,2,93,4,4,4,4,4,12,2,2,2,6,6,0,2024-01-07 14:46:00,0
5573,5573,5573,5573,2010,88,343,88,216,2010,127,88,209,202,197,88,88,343,127,31,31,0,88,7,7,7,7,7,15,2,2,2,7,7,0,2024-01-07 14:48:00,0
5591,5591,5591,5591,2025,87,348,87,224,2025,124,87,194,182,180,87,87,348,124,28,28,5,87,4,4,4,4,4,6,2,2,2,12,12,0,2024-01-07 14:50:00,0
4935,4934,4934,4934,1862,46,380,46,156,1862,224,46,138,132,131,46,46,380,224,28,28,0,46,4,4,4,4,4,3,2,2,2,6,6,0,2024-01-07 14:52:00,0
5259,5260,5260,5260,2028,24,274,24,145,2028,129,24,133,121,119,24,24,274,129,28,28,0,24,4,4,4,4,4,6,2,2,2,12,12,0,2024-01-07 14:54:00,0
5256,5254,5254,5254,2032,24,263,24,149,2032,114,24,132,123,120,24,24,263,114,31,31,4,24,7,7,7,7,7,9,2,2,2,9,9,0,2024-01-07 14:56:00,0
5263,5265,5265,5265,2028,24,273,24,145,2028,128,24,136,123,119,24,24,273,128,28,28,0,24,4,4,4,4,4,12,2,2,2,13,13,0,2024-01-07 14:58:00,0
5233,5231,5231,5231,2018,24,256,24,144,2018,112,24,133,119,118,24,24,256,112,28,28,4,24,4,4,4,4,3,3,2,2,2,14,14,1,2024-01-07 15:00:00,0
5289,5293,5291,5291,2001,24,647,24,148,2001,499,24,139,124,118,24,24,647,499,31,31,0,24,7,7,7,7,7,18,2,2,2,15,15,0,2024-01-07 15:02:00,0
5229,5229,5229,5229,2013,24,276,24,144,2013,132,24,134,120,119,24,24,276,132,28,28,0,24,4,4,4,4,4,3,2,2,2,14,14,0,2024-01-07 15:04:00,0
5223,5223,5223,5223,2019,24,258,24,144,2019,114,24,125,118,117,24,24,258,114,27,27,4,24,3,3,3,3,3,3,2,2,2,7,7,0,2024-01-07 15:06:00,0
5250,5250,5250,5250,2022,24,272,24,145,2022,127,24,130,121,119,24,24,272,127,28,28,0,24,4,4,4,4,4,6,2,2,2,9,9,0,2024-01-07 15:08:00,0
5254,5254,5254,5254,2013,24,308,24,150,2013,158,24,127,118,118,24,24,308,158,33,33,4,24,8,7,7,7,7,0,2,2,2,9,9,0,2024-01-07 15:10:00,3
5191,5191,5190,5190,2010,24,357,24,144,2010,213,24,128,122,117,24,24,357,213,28,28,0,24,4,4,4,4,3,15,2,2,2,6,6,1,2024-01-07 15:12:00,0
5227,5228,5228,5228,2014,22,265,22,145,2014,120,22,135,124,118,22,22,265,120,28,28,0,22,4,4,4,4,4,18,2,2,2,11,11,0,2024-01-07 15:14:00,0
5257,5256,5256,5256,2034,24,258,24,146,2034,112,24,135,123,118,24,24,258,112,28,28,2,24,4,4,4,4,4,15,2,2,2,12,12,0,2024-01-07 15:16:00,0
5241,5241,5241,5241,2028,24,257,24,148,2028,109,24,130,121,119,24,24,257,109,31,31,0,24,7,7,7,7,7,6,2,2,2,9,9,0,2024-01-07 15:18:00,0
5280,5281,5281,5281,2027,24,294,24,146,2027,148,24,128,122,119,24,24,294,148,28,28,0,24,4,4,4,4,4,9,2,2,2,6,6,0,2024-01-07 15:20:00,0
5235,5235,5235,5235,2021,24,260,24,145,2021,115,24,135,122,118,24,24,260,115,28,28,4,24,4,4,4,4,3,12,2,2,2,13,13,1,2024-01-07 15:22:00,0
5231,5230,5230,5230,2027,24,243,24,148,2027,95,24,130,119,118,24,24,243,95,31,31,0,24,7,7,7,7,7,3,2,2,2,11,11,0,2024-01-07 15:24:00,0
5290,5290,5290,5290,2025,24,293,24,145,2025,148,24,140,123,120,24,24,293,148,27,27,4,24,3,3,3,3,3,9,2,2,2,17,17,0,2024-01-07 15:26:00,0
5274,5274,5274,5274,2027,24,294,24,145,2027,149,24,132,118,118,24,24,294,149,28,28,0,24,4,4,4,4,3,0,2,2,2,14,14,1,2024-01-07 15:28:00,0
5256,5257,5257,5257,2022,24,271,24,145,2022,126,24,134,122,118,24,24,271,126,28,28,0,24,4,4,4,4,4,12,2,2,2,12,12,0,2024-01-07 15:30:00,0
5238,5234,5234,5234,2031,24,253,24,148,2031,105,24,129,119,118,24,24,253,105,31,31,4,24,7,7,7,7,7,3,2,2,2,10,10,0,2024-01-07 15:32:00,0
5223,5227,5227,5227,2014,24,264,24,145,2014,119,24,131,120,119,24,24,264,119,28,28,0,24,4,4,4,4,4,3,2,2,2,11,11,0,2024-01-07 15:34:00,0
5217,5217,5217,5217,2014,24,268,24,144,2014,124,24,129,121,118,24,24,268,124,28,28,0,24,4,4,4,4,4,9,2,2,2,8,8,0,2024-01-07 15:36:00,0
5245,5246,5244,5244,2031,24,243,24,145,2031,98,24,135,123,119,24,24,243,98,28,28,0,24,4,4,4,4,3,12,2,2,2,12,12,1,2024-01-07 15:38:00,0
5286,5287,5287,5287,2038,22,281,22,149,2038,132,22,134,121,118,22,22,281,132,31,31,0,22,7,7,7,7,7,9,2,2,2,13,13,0,2024-01-07 15:40:00,0
5242,5242,5242,5242,2023,24,260,24,145,2023,115,24,135,120,119,24,24,260,115,27,27,5,24,3,3,3,3,3,3,2,2,2,15,15,0,2024-01-07 15:42:00,0
5252,5252,5252,5252,2026,24,265,24,145,2026,120,24,134,129,119,24,24,265,120,28,28,0,24,4,4,4,4,3,30,2,2,2,5,5,1,2024-01-07 15:44:00,0
5237,5237,5237,5237,2031,24,256,24,149,2031,107,24,124,120,119,24,24,256,107,32,32,1,24,8,8,8,8,8,3,2,2,2,4,4,0,2024-01-07 15:46:00,0
5240,5240,5240,5240,2026,24,358,24,145,2026,213,24,125,121,120,24,24,358,213,27,27,1,24,3,3,3,3,3,3,2,2,2,4,4,0,2024-01-07 15:48:00,0
5252,5251,5251,5251,2029,24,269,24,145,2029,124,24,128,120,118,24,24,269,124,28,28,1,24,4,4,4,4,4,6,2,2,2,8,8,0,2024-01-07 15:50:00,0
5219,5220,5220,5220,2018,24,258,24,145,2018,113,24,124,120,118,24,24,258,113,28,28,2,24,4,4,4,4,4,6,2,2,2,4,4,0,2024-01-07 15:52:00,0
5254,5274,5253,5253,2029,24,269,24,148,2029,121,24,129,121,119,24,24,269,121,31,31,0,24,7,7,7,7,7,6,2,2,2,8,8,0,2024-01-07 15:54:00,0
5248,5249,5249,5249,2029,24,269,24,146,2029,123,24,125,121,119,24,24,269,123,28,28,0,24,4,4,4,4,4,6,2,2,2,4,4,0,2024-01-07 15:56:00,0
5266,5265,5265,5265,2029,24,271,24,145,2029,126,24,133,121,118,24,24,271,126,28,28,4,24,4,4,4,4,4,9,2,2,2,12,12,0,2024-01-07 15:58:00,0
5179,5180,5180,5180,2000,24,259,24,145,2000,114,24,126,118,117,24,24,259,114,29,28,0,24,4,4,5,4,3,3,2,2,2,8,8,1,2024-01-07 16:00:00,0
5297,5297,5297,5297,2018,24,626,24,147,2018,479,24,138,123,118,24,24,626,479,30,31,4,24,7,7,6,7,7,15,2,2,2,15,15,0,2024-01-07 16:02:00,0
5263,5263,5263,5263,2018,24,293,24,144,2018,149,24,133,124,118,24,24,293,149,27,27,0,24,3,3,3,3,3,18,2,2,2,9,9,0,2024-01-07 16:04:00,0
5234,5234,5234,5234,2028,22,257,22,145,2028,112,22,132,120,118,22,22,257,112,28,28,0,22,4,4,4,4,3,6,2,2,2,12,12,1,2024-01-07 16:06:00,0
5237,5237,5237,5237,2023,24,270,24,149,2023,121,24,127,120,118,24,24,270,121,32,32,2,24,8,8,8,8,8,6,2,2,2,7,7,0,2024-01-07 16:08:00,0
5235,5235,5235,5235,2026,24,252,24,144,2026,108,24,132,121,119,24,24,252,108,27,27,0,24,3,3,3,3,3,6,2,2,2,11,11,0,2024-01-07 16:10:00,0
5231,5250,5231,5231,2015,24,362,24,145,2015,217,24,133,121,118,24,24,362,217,28,28,1,24,4,4,4,4,4,9,2,2,2,12,12,0,2024-01-07 16:12:00,0
5287,5287,5287,5287,2029,24,289,24,145,2029,144,24,138,123,119,24,24,289,144,28,28,1,24,4,4,4,4,4,12,2,2,2,15,15,0,2024-01-07 16:14:00,0
5245,5245,5245,5245,2031,24,260,24,149,2031,111,24,127,121,118,24,24,260,111,31,31,0,24,7,7,7,7,6,9,2,2,2,6,6,1,2024-01-07 16:16:00,0
5248,5248,5248,5248,2031,24,260,24,145,2031,115,24,127,120,118,24,24,260,115,28,28,4,24,4,4,4,4,4,6,2,2,2,7,7,0,2024-01-07 16:18:00,0
5189,5188,5188,5188,2003,24,261,24,144,2003,117,24,126,119,117,24,24,261,117,28,28,0,24,4,4,4,4,3,6,2,2,2,7,7,1,2024-01-07 16:20:00,0
7335,7334,7334,7334,2828,34,468,34,204,2828,264,34,182,170,166,34,34,468,264,41,41,0,34,8,8,8,8,7,12,3,3,3,12,12,1,2024-01-07 16:22:00,0
5260,5261,5260,5260,2033,24,258,24,146,2033,112,24,136,119,119,24,24,258,112,28,28,0,24,4,4,4,4,4,0,2,2,2,17,17,0,2024-01-07 16:24:00,0
5263,5263,5263,5263,2023,24,281,24,144,2023,137,24,135,122,118,24,24,281,137,27,27,0,24,3,3,3,3,3,12,2,2,2,13,13,0,2024-01-07 16:26:00,0
5280,5281,5281,5281,2029,24,388,24,145,2029,243,24,132,122,118,24,24,388,243,28,28,3,24,4,4,4,4,4,12,2,2,2,10,10,0,2024-01-07 16:28:00,0
5239,5239,5239,5239,2015,24,277,24,148,2015,129,24,132,119,118,24,24,277,129,31,31,0,24,7,7,7,7,7,3,2,2,2,13,13,0,2024-01-07 16:30:00,0
5227,5227,5226,5226,2015,23,372,22,144,2015,228,22,123,119,118,22,22,372,228,28,28,0,22,4,4,4,4,3,3,2,2,2,4,4,1,2024-01-07 16:32:00,0
5208,5210,5210,5210,2018,23,245,24,145,2018,100,24,137,122,117,24,24,245,100,28,28,2,24,4,4,4,4,4,15,2,2,2,15,15,0,2024-01-07 16:34:00,0
5224,5223,5223,5223,2022,24,254,24,145,2022,109,24,124,119,118,24,24,254,109,28,28,0,24,4,4,4,4,3,3,2,2,2,5,5,1,2024-01-07 16:36:00,0
5256,5256,5256,5256,2033,24,260,24,149,2033,111,24,135,123,119,24,24,260,111,31,31,4,24,7,7,7,7,7,12,2,2,2,12,12,0,2024-01-07 16:38:00,0
5249,5250,5250,5250,2018,24,281,24,144,2018,137,24,130,124,119,24,24,281,137,28,28,0,24,4,4,4,4,4,15,2,2,2,6,6,0,2024-01-07 16:40:00,0
5236,5236,5236,5236,2012,24,280,24,144,2012,136,24,131,119,117,24,24,280,136,27,27,0,24,3,3,3,3,3,6,2,2,2,12,12,0,2024-01-07 16:42:00,0
5255,5255,5255,5255,2032,24,270,24,149,2032,121,24,130,122,119,24,24,270,121,32,32,2,24,8,8,8,8,8,9,2,2,2,8,8,0,2024-01-07 16:44:00,0
5234,5234,5234,5234,2016,24,274,24,145,2016,129,24,124,118,118,24,24,274,129,27,27,0,24,3,3,3,3,3,0,2,2,2,6,6,0,2024-01-07 16:46:00,0
5233,5233,5233,5233,2012,24,276,24,144,2012,132,24,135,124,120,24,24,276,132,28,28,1,24,4,4,4,4,3,12,2,2,2,11,11,1,2024-01-07 16:48:00,0
5237,5237,5237,5237,2019,24,274,24,145,2019,129,24,131,125,119,24,24,274,129,28,28,1,24,4,4,4,4,4,18,2,2,2,6,6,0,2024-01-07 16:50:00,0
5235,5235,5235,5235,2023,24,268,24,148,2023,120,24,126,119,118,24,24,268,120,31,31,0,24,7,7,7,7,7,3,2,2,2,7,7,0,2024-01-07 16:52:00,0
5249,5250,5249,5249,2019,24,287,24,145,2019,142,24,126,122,118,24,24,287,142,28,28,4,24,4,4,4,4,3,12,2,2,2,4,4,1,2024-01-07 16:54:00,0
5182,5182,5182,5182,1999,22,264,22,143,1999,121,22,123,118,117,22,22,264,121,27,27,0,22,4,4,4,4,4,3,2,2,2,5,5,0,2024-01-07 16:56:00,0
5234,5234,5234,5234,2027,24,250,24,145,2027,105,24,129,122,119,24,24,250,105,28,28,0,24,4,4,4,4,3,9,2,2,2,7,7,1,2024-01-07 16:58:00,0
5281,5280,5280,5280,2037,24,285,24,149,2037,136,24,128,121,119,24,24,285,136,31,31,4,24,7,7,7,7,7,6,2,2,2,7,7,0,2024-01-07 17:00:00,0
5340,5360,5340,5340,2026,24,545,24,146,2026,399,24,140,127,119,24,24,545,399,28,28,0,24,4,4,4,4,4,24,2,2,2,13,13,0,2024-01-07 17:02:00,0
5269,5269,5269,5269,2035,24,371,24,145,2035,226,24,127,119,118,24,24,371,226,27,27,0,24,3,3,3,3,3,3,2,2,2,8,8,0,2024-01-07 17:04:00,0
5227,5226,5226,5226,2018,24,259,24,144,2018,115,24,131,122,118,24,24,259,115,28,28,0,24,4,4,4,4,4,12,2,2,2,9,9,0,2024-01-07 17:06:00,0
5226,5228,5228,5228,2021,24,261,24,148,2021,113,24,130,120,119,24,24,261,113,31,31,0,24,7,7,7,7,7,3,2,2,2,10,10,0,2024-01-07 17:08:00,0
5252,5252,5252,5252,2018,24,285,24,145,2018,140,24,131,123,118,24,24,285,140,28,28,3,24,4,4,4,4,3,15,2,2,2,8,8,1,2024-01-07 17:10:00,0
5260,5259,5259,5259,2024,24,380,24,145,2024,235,24,128,122,118,24,24,380,235,28,28,0,24,4,4,4,4,4,12,2,2,2,6,6,0,2024-01-07 17:12:00,0
5248,5248,5248,5248,2031,24,263,24,148,2031,115,24,128,121,120,24,24,263,115,31,31,0,24,7,7,7,7,6,3,2,2,2,7,7,1,2024-01-07 17:14:00,0
5240,5241,5241,5241,2030,24,253,24,146,2030,107,24,129,121,119,24,24,253,107,28,28,0,24,4,4,4,4,4,6,2,2,2,8,8,0,2024-01-07 17:16:00,0
5273,5273,5273,5273,2032,24,278,24,145,2032,133,24,128,122,118,24,24,278,133,28,28,0,24,4,4,4,4,4,12,2,2,2,6,6,0,2024-01-07 17:18:00,0
5243,5242,5242,5242,2028,24,253,24,144,2028,109,24,132,121,118,24,24,253,109,27,27,1,24,3,3,3,3,3,9,2,2,2,11,11,0,2024-01-07 17:20:00,0
5184,5183,5183,5183,2001,22,270,22,148,2001,122,22,127,121,119,22,22,270,122,32,32,0,22,8,8,8,8,8,6,2,2,2,6,6,0,2024-01-07 17:22:00,0
5255,5256,5256,5256,2019,24,292,24,148,2019,144,24,132,120,118,24,24,292,144,31,31,1,24,5,3,3,3,3,6,2,2,2,12,12,0,2024-01-07 17:24:00,6
5244,5244,5244,5244,2011,24,289,24,145,2011,144,24,134,123,117,24,24,289,144,28,28,1,24,4,4,4,4,3,18,2,2,2,11,11,1,2024-01-07 17:26:00,0
5170,5171,5171,5171,2013,24,223,24,145,2013,78,24,122,119,118,24,24,223,78,28,28,0,24,4,4,4,4,4,3,2,2,2,3,3,0,2024-01-07 17:28:00,0
5236,5237,5236,5236,2023,24,267,24,148,2023,119,24,128,119,118,24,24,267,119,31,31,2,24,7,7,7,7,7,3,2,2,2,9,9,0,2024-01-07 17:30:00,0
5281,5281,5281,5281,2033,24,291,24,152,2033,139,24,131,121,120,24,24,291,139,34,34,0,24,5,4,4,4,4,3,2,2,2,10,10,0,2024-01-07 17:32:00,11
5254,5253,5253,5253,2027,24,268,24,145,2027,123,24,133,122,118,24,24,268,123,28,28,0,24,4,4,4,4,4,12,2,2,2,11,11,0,2024-01-07 17:34:00,0
5240,5237,5237,5237,2029,24,254,24,151,2029,103,24,131,121,120,24,24,254,103,33,33,4,24,8,7,7,7,6,3,2,2,2,10,10,1,2024-01-07 17:36:00,3
5233,5237,5237,5237,2017,24,272,24,147,2017,125,24,129,120,118,24,24,272,125,30,30,0,24,5,4,4,4,4,6,2,2,2,9,9,0,2024-01-07 17:38:00,3
5278,5278,5278,5278,2022,24,303,24,145,2022,158,24,136,123,118,24,24,303,158,28,28,2,24,4,4,4,4,4,15,2,2,2,13,13,0,2024-01-07 17:40:00,0
5172,5171,5171,5171,1980,24,259,24,144,1980,115,24,137,122,118,24,24,259,115,28,28,0,24,4,4,4,4,3,12,2,2,2,15,15,1,2024-01-07 17:42:00,0
5227,5228,5228,5228,2008,22,296,22,148,2008,148,22,122,119,117,22,22,296,148,31,31,0,22,7,7,7,7,7,6,2,2,2,3,3,0,2024-01-07 17:44:00,0
5187,5185,5185,5185,2001,24,264,24,144,2001,120,24,127,120,118,24,24,264,120,28,28,4,24,3,3,3,3,3,6,2,2,2,7,7,0,2024-01-07 17:46:00,2
5228,5230,5230,5230,2020,24,259,24,145,2020,114,24,129,121,118,24,24,259,114,28,28,0,24,4,4,4,4,3,9,2,2,2,8,8,1,2024-01-07 17:48:00,0
5245,5244,5244,5244,2023,24,272,24,145,2023,127,24,129,121,119,24,24,272,127,28,28,2,24,4,4,4,4,4,6,2,2,2,8,8,0,2024-01-07 17:50:00,0
5228,5229,5229,5229,2026,24,252,24,148,2026,104,24,127,122,119,24,24,252,104,31,31,0,24,7,7,7,7,7,9,2,2,2,5,5,0,2024-01-07 17:52:00,0
5264,5263,5263,5263,2031,24,270,24,146,2031,124,24,132,120,119,24,24,270,124,28,28,0,24,4,4,4,4,3,3,2,2,2,12,12,1,2024-01-07 17:54:00,0
5247,5247,5247,5247,2021,24,270,24,144,2021,126,24,134,123,120,24,24,270,126,28,28,2,24,4,4,4,4,4,9,2,2,2,11,11,0,2024-01-07 17:56:00,0
5243,5244,5244,5244,2029,24,247,24,146,2029,101,24,133,122,118,24,24,247,101,28,28,0,24,4,4,4,4,3,12,2,2,2,11,11,1,2024-01-07 17:58:00,0
5204,5203,5203,5203,2015,24,250,24,149,2015,101,24,129,123,120,24,24,250,101,33,33,0,24,8,7,7,7,7,9,2,2,2,6,6,0,2024-01-07 18:00:00,3
5154,5155,5155,5155,1976,24,255,24,147,1976,108,24,128,123,117,24,24,255,108,30,30,2,24,5,4,4,4,4,18,2,2,2,5,5,0,2024-01-07 18:02:00,3
5122,5122,5122,5122,1997,22,196,22,145,1997,51,22,124,120,118,22,22,196,51,28,28,0,22,4,4,4,4,3,6,2,2,2,4,4,1,2024-01-07 18:04:00,0
5269,5267,5267,5267,2021,24,303,24,150,2021,153,24,132,121,118,24,24,303,153,33,33,4,24,7,7,7,7,7,9,2,2,2,11,11,0,2024-01-07 18:06:00,4
5256,5257,5257,5257,2023,24,286,24,145,2023,141,24,127,121,119,24,24,286,141,28,28,0,24,4,4,4,4,4,6,2,2,2,6,6,0,2024-01-07 18:08:00,0
5202,5201,5201,5201,2002,24,281,24,145,2002,136,24,126,119,117,24,24,281,136,29,29,0,24,4,3,3,3,3,6,2,2,2,7,7,0,2024-01-07 18:10:00,3
5246,5248,5248,5248,2020,24,369,24,145,2020,224,24,138,123,119,24,24,369,224,28,28,4,24,4,4,4,4,4,12,2,2,2,15,15,0,2024-01-07 18:12:00,0
5251,5251,5251,5251,2035,24,261,24,149,2035,112,24,125,119,118,24,24,261,112,31,31,0,24,7,7,7,7,7,3,2,2,2,6,6,0,2024-01-07 18:14:00,0
5281,5281,5281,5281,2042,24,275,24,146,2042,129,24,125,122,119,24,24,275,129,28,28,1,24,4,4,4,4,3,9,2,2,2,3,3,1,2024-01-07 18:16:00,0
5213,5213,5213,5213,2023,24,245,24,145,2023,100,24,123,121,118,24,24,245,100,28,28,1,24,4,4,4,4,4,9,2,2,2,2,2,0,2024-01-07 18:18:00,0
5233,5233,5233,5233,2029,24,244,24,145,2029,99,24,132,121,118,24,24,244,99,28,28,0,24,4,4,4,4,3,9,2,2,2,11,11,1,2024-01-07 18:20:00,0
5233,5233,5233,5233,2012,24,279,24,148,2012,131,24,128,119,118,24,24,279,131,31,31,2,24,7,7,7,7,7,3,2,2,2,9,9,0,2024-01-07 18:22:00,0
5239,5239,5239,5239,2023,24,268,24,145,2023,123,24,127,122,118,24,24,268,123,28,28,0,24,4,4,4,4,4,12,2,2,2,5,5,0,2024-01-07 18:24:00,0
5217,5216,5216,5216,2016,23,244,23,143,2016,101,23,135,123,119,23,23,244,101,27,27,0,23,3,3,3,3,3,12,2,2,2,12,12,0,2024-01-07 18:26:00,0
5216,5216,5216,5216,2020,23,250,23,149,2020,101,23,128,120,118,23,23,250,101,32,32,4,23,8,8,8,8,8,6,2,2,2,8,8,0,2024-01-07 18:28:00,0
5251,5252,5252,5252,2029,24,260,24,145,2029,115,24,134,122,119,24,24,260,115,27,27,0,24,3,3,3,3,3,9,2,2,2,12,12,0,2024-01-07 18:30:00,0
5262,5261,5261,5261,2025,24,381,24,144,2025,237,24,133,120,118,24,24,381,237,28,28,4,24,4,4,4,4,3,6,2,2,2,13,13,1,2024-01-07 18:32:00,0
5203,5204,5204,5204,2005,24,266,24,145,2005,121,24,130,120,118,24,24,266,121,28,28,0,24,4,4,4,4,4,6,2,2,2,10,10,0,2024-01-07 18:34:00,0
5234,5233,5233,5233,2027,24,249,24,148,2027,101,24,133,125,118,24,24,249,101,31,31,0,24,7,7,7,7,6,21,2,2,2,8,8,1,2024-01-07 18:36:00,0
5228,5249,5228,5228,2022,24,255,24,145,2022,110,24,127,121,118,24,24,255,110,28,28,4,24,4,4,4,4,4,9,2,2,2,6,6,0,2024-01-07 18:38:00,0
5264,5264,5264,5264,2025,24,274,24,145,2025,129,24,139,124,120,24,24,274,129,28,28,0,24,4,4,4,4,4,12,2,2,2,15,15,0,2024-01-07 18:40:00,0
5219,5220,5220,5220,2015,24,354,24,144,2015,210,24,127,120,118,24,24,354,210,27,27,2,24,3,3,3,3,3,6,2,2,2,7,7,0,2024-01-07 18:42:00,0
5248,5245,5245,5245,2031,24,261,24,150,2031,111,24,128,120,118,24,24,261,111,32,32,0,24,8,8,8,8,8,6,2,2,2,8,8,0,2024-01-07 18:44:00,0
5235,5237,5237,5237,2029,24,248,24,144,2029,104,24,129,121,119,24,24,248,104,27,27,0,24,3,3,3,3,3,6,2,2,2,8,8,0,2024-01-07 18:46:00,0
5248,5249,5249,5249,2029,24,357,24,146,2029,211,24,136,124,119,24,24,357,211,28,28,4,24,4,4,4,4,3,15,2,2,2,12,12,1,2024-01-07 18:48:00,0
5233,5232,5232,5232,2027,24,255,23,149,2027,106,23,124,121,118,23,23,255,106,32,32,0,23,8,8,8,8,8,9,2,2,2,3,3,0,2024-01-07 18:50:00,0
5225,5225,5225,5225,2023,23,247,24,144,2023,103,24,130,120,118,24,24,247,103,27,27,4,24,3,3,3,3,3,6,2,2,2,10,10,0,2024-01-07 18:52:00,0
5271,5271,5271,5271,2030,23,281,23,146,2030,135,23,128,122,119,23,23,281,135,28,28,0,23,4,4,4,4,3,9,2,2,2,6,6,1,2024-01-07 18:54:00,0
5253,5253,5253,5253,2036,24,255,24,145,2036,110,24,128,120,119,24,24,255,110,28,28,0,24,4,4,4,4,4,3,2,2,2,8,8,0,2024-01-07 18:56:00,0
5216,5216,5216,5216,2013,24,372,24,148,2013,224,24,127,120,117,24,24,372,224,31,31,4,24,7,7,7,7,6,9,2,2,2,7,7,1,2024-01-07 18:58:00,0
5246,5247,5247,5247,2037,24,246,24,145,2037,101,24,125,120,119,24,24,246,101,28,28,0,24,4,4,4,4,4,3,2,2,2,5,5,0,2024-01-07 19:00:00,0
5239,5242,5238,5238,2013,24,480,24,146,2013,334,24,130,120,118,24,24,480,334,28,28,0,24,4,4,4,4,4,6,2,2,2,10,10,0,2024-01-07 19:02:00,0
5266,5267,5267,5267,2025,24,279,24,144,2025,135,24,130,121,118,24,24,279,135,27,27,0,24,3,3,3,3,3,9,2,2,2,9,9,0,2024-01-07 19:04:00,0
5277,5276,5276,5276,2042,24,267,24,150,2042,117,24,133,122,120,24,24,267,117,32,32,0,24,8,8,8,8,8,6,2,2,2,11,11,0,2024-01-07 19:06:00,0
5239,5240,5240,5240,2019,24,266,24,144,2019,122,24,129,119,118,24,24,266,122,27,27,5,24,3,3,3,3,3,3,2,2,2,10,10,0,2024-01-07 19:08:00,0
5221,5221,5221,5221,2020,24,256,24,145,2020,111,24,128,120,118,24,24,256,111,28,28,0,24,4,4,4,4,3,6,2,2,2,8,8,1,2024-01-07 19:10:00,0
5225,5225,5225,5225,2021,24,254,24,148,2021,106,24,132,120,118,24,24,254,106,31,31,0,24,7,7,7,7,7,6,2,2,2,12,12,0,2024-01-07 19:12:00,0
5241,5241,5241,5241,2028,24,254,24,145,2028,109,24,131,121,118,24,24,254,109,28,28,4,24,4,4,4,4,3,9,2,2,2,10,10,1,2024-01-07 19:14:00,0
5250,5250,5250,5250,2031,24,259,24,146,2031,113,24,127,121,118,24,24,259,113,28,28,0,24,4,4,4,4,4,9,2,2,2,6,6,0,2024-01-07 19:16:00,0
5220,5219,5219,5219,2034,23,335,23,145,2034,190,23,123,119,119,23,23,335,190,28,28,4,23,4,4,4,4,4,0,2,2,2,4,4,0,2024-01-07 19:18:00,0
5240,5241,5241,5241,2025,23,260,23,148,2025,112,23,136,121,118,23,23,260,112,31,31,0,23,7,7,7,7,7,9,2,2,2,15,15,0,2024-01-07 19:20:00,0
5181,5181,5181,5181,1991,24,364,24,144,1991,220,24,136,123,118,24,24,364,220,28,28,0,24,4,4,4,4,4,15,2,2,2,13,13,0,2024-01-07 19:22:00,0
5238,5237,5236,5236,2031,24,244,24,145,2031,99,24,131,119,118,24,24,244,99,28,28,0,24,4,4,4,4,3,3,2,2,2,12,12,1,2024-01-07 19:24:00,0
5232,5234,5234,5234,2018,24,261,24,144,2018,117,24,132,124,120,24,24,261,117,27,27,0,24,3,3,3,3,3,12,2,2,2,8,8,0,2024-01-07 19:26:00,0
5249,5249,5249,5249,2028,24,272,24,148,2028,124,24,124,120,119,24,24,272,124,31,31,4,24,7,7,7,7,7,3,2,2,2,4,4,0,2024-01-07 19:28:00,0
5277,5277,5277,5277,2037,24,275,24,146,2037,129,24,131,122,121,24,24,275,129,28,28,1,24,4,4,4,4,3,3,2,2,2,9,9,1,2024-01-07 19:30:00,0
5271,5271,5271,5271,2030,24,276,24,145,2030,131,24,135,123,118,24,24,276,131,28,28,0,24,4,4,4,4,4,15,2,2,2,12,12,0,2024-01-07 19:32:00,0
5232,5231,5231,5231,2024,24,262,24,148,2024,114,24,127,120,118,24,24,262,114,31,31,0,24,7,7,7,7,7,6,2,2,2,7,7,0,2024-01-07 19:34:00,0
5256,5257,5257,5257,2029,24,271,24,146,2029,125,24,126,119,118,24,24,271,125,28,28,0,24,4,4,4,4,4,3,2,2,2,7,7,0,2024-01-07 19:36:00,0
5237,5237,5237,5237,2025,24,251,24,145,2025,106,24,134,124,120,24,24,251,106,28,28,2,24,4,4,4,4,4,12,2,2,2,10,10,0,2024-01-07 19:38:00,0
5280,5279,5279,5279,2031,24,280,24,145,2031,135,24,135,121,118,24,24,280,135,28,28,3,24,4,4,4,4,3,9,2,2,2,14,14,1,2024-01-07 19:40:00,0
5211,5211,5211,5211,2005,23,268,23,148,2005,120,23,129,122,118,23,23,268,120,31,31,0,23,7,7,7,7,7,12,2,2,2,7,7,0,2024-01-07 19:42:00,0
5263,5263,5263,5263,2040,24,254,24,145,2040,109,24,129,123,119,24,24,254,109,27,27,2,24,3,3,3,3,3,12,2,2,2,6,6,0,2024-01-07 19:44:00,0
5194,5194,5194,5194,2007,23,256,23,143,2007,113,23,126,119,117,23,23,256,113,27,27,0,23,4,4,4,4,3,6,2,2,2,7,7,1,2024-01-07 19:46:00,0
5228,5228,5228,5228,2012,24,277,24,149,2012,128,24,129,122,118,24,24,277,128,32,32,0,24,8,8,8,8,8,12,2,2,2,7,7,0,2024-01-07 19:48:00,0
5219,5220,5220,5220,2017,24,308,24,144,2017,164,24,127,120,118,24,24,308,113,28,28,4,24,4,4,3,3,3,6,2,2,2,7,7,0,2024-01-07 19:50:00,52
5224,5221,5221,5221,2031,24,235,24,145,2031,90,24,127,123,118,24,24,235,90,28,28,0,24,4,4,4,4,4,15,2,2,2,4,4,0,2024-01-07 19:52:00,0
5213,5215,5215,5215,2021,24,244,24,145,2021,99,24,126,120,118,24,24,244,99,28,28,2,24,4,4,4,4,4,6,2,2,2,6,6,0,2024-01-07 19:54:00,0
5248,5248,5248,5248,2029,24,263,24,149,2029,114,24,130,121,119,24,24,263,114,31,31,0,24,7,7,7,7,7,6,2,2,2,9,9,0,2024-01-07 19:56:00,0
5266,5267,5267,5267,2034,24,269,24,145,2034,124,24,132,120,118,24,24,269,124,28,28,0,24,4,4,4,4,4,6,2,2,2,12,12,0,2024-01-07 19:58:00,0
5248,5246,5246,5246,2023,24,267,24,145,2023,122,24,133,120,118,24,24,267,122,28,28,4,24,4,4,4,4,3,6,2,2,2,13,13,1,2024-01-07 20:00:00,0
5246,5248,5248,5248,2019,24,772,24,145,2019,627,24,128,121,119,24,24,772,627,27,27,0,24,3,3,3,3,3,6,2,2,2,7,7,0,2024-01-07 20:02:00,0
5230,5230,5230,5230,2029,24,241,24,148,2029,93,24,133,122,120,24,24,241,93,31,31,2,24,7,7,7,7,7,6,2,2,2,11,11,0,2024-01-07 20:04:00,0
5235,5232,5232,5232,2026,24,257,23,145,2026,112,23,126,122,118,23,23,257,112,28,28,2,23,4,4,4,4,3,12,2,2,2,4,4,1,2024-01-07 20:06:00,0
5234,5235,5235,5235,2021,23,264,24,145,2021,119,24,127,120,118,24,24,264,119,28,28,0,24,4,4,4,4,4,6,2,2,2,7,7,0,2024-01-07 20:08:00,0
5230,5232,5232,5232,2028,23,265,23,149,2028,116,23,128,121,118,23,23,265,116,31,31,0,23,7,7,7,7,7,9,2,2,2,7,7,0,2024-01-07 20:10:00,0
5262,5262,5262,5262,2022,24,273,24,145,2022,128,24,137,122,120,24,24,273,128,28,28,0,24,4,4,4,4,4,6,2,2,2,15,15,0,2024-01-07 20:12:00,0
5252,5251,5251,5251,2030,24,266,24,145,2030,121,24,128,120,118,24,24,266,121,28,28,0,24,4,4,4,4,4,6,2,2,2,8,8,0,2024-01-07 20:14:00,0
5258,5259,5259,5259,2025,24,278,24,145,2025,133,24,127,121,118,24,24,278,133,28,28,5,24,4,4,4,4,3,9,2,2,2,6,6,1,2024-01-07 20:16:00,0
5250,5250,5250,5250,2022,24,275,24,148,2022,127,24,132,119,118,24,24,275,127,31,31,0,24,7,7,7,7,7,3,2,2,2,13,13,0,2024-01-07 20:18:00,0
5228,5228,5228,5228,2027,24,246,24,144,2027,102,24,130,120,119,24,24,246,102,27,27,0,24,3,3,3,3,3,3,2,2,2,10,10,0,2024-01-07 20:20:00,0
5224,5224,5224,5224,2009,24,272,24,145,2009,127,24,133,123,118,24,24,272,127,28,28,0,24,4,4,4,4,3,15,2,2,2,10,10,1,2024-01-07 20:22:00,0
5229,5228,5228,5228,2028,24,243,24,146,2028,97,24,128,120,118,24,24,243,97,28,28,1,24,4,4,4,4,4,6,2,2,2,8,8,0,2024-01-07 20:24:00,0
5256,5258,5257,5257,2024,24,279,24,148,2024,131,24,131,120,118,24,24,279,131,31,31,4,24,7,7,7,7,7,6,2,2,2,11,11,0,2024-01-07 20:26:00,0
5252,5251,5251,5251,2036,24,253,24,145,2036,108,24,132,122,119,24,24,253,108,28,28,0,24,4,4,4,4,4,9,2,2,2,10,10,0,2024-01-07 20:28:00,0
5269,5270,5270,5270,2030,24,272,24,146,2030,126,24,135,124,118,24,24,272,126,28,28,4,24,4,4,4,4,4,18,2,2,2,11,11,0,2024-01-07 20:30:00,0
5243,5243,5243,5243,2021,23,273,23,148,2021,125,23,129,120,118,23,23,273,125,31,31,0,23,7,7,7,7,6,6,2,2,2,9,9,1,2024-01-07 20:32:00,0
5239,5239,5239,5239,2019,23,276,23,145,2019,131,23,133,120,119,23,23,276,131,28,28,0,23,4,4,4,4,4,3,2,2,2,13,13,0,2024-01-07 20:34:00,0
5256,5256,5256,5256,2024,24,272,24,144,2024,128,24,133,121,118,24,24,272,128,27,27,0,24,3,3,3,3,3,9,2,2,2,12,12,0,2024-01-07 20:36:00,0
5233,5232,5232,5232,2021,24,264,24,145,2021,119,24,124,118,118,24,24,264,119,28,28,0,24,4,4,4,4,3,0,2,2,2,6,6,1,2024-01-07 20:38:00,0
5266,5267,5267,5267,2028,24,288,24,149,2028,139,24,127,120,118,24,24,288,139,32,32,4,24,8,8,8,8,8,6,2,2,2,7,7,0,2024-01-07 20:40:00,0
5243,5243,5243,5243,2023,24,264,24,144,2023,120,24,132,122,118,24,24,264,120,27,27,1,24,3,3,3,3,3,12,2,2,2,10,10,0,2024-01-07 20:42:00,0
5286,5285,5285,5285,2035,24,280,24,146,2035,134,24,136,123,119,24,24,280,134,28,28,0,24,4,4,4,4,4,12,2,2,2,13,13,0,2024-01-07 20:44:00,0
5268,5268,5268,5268,2031,24,275,24,149,2031,126,24,130,122,118,24,24,275,126,31,31,2,24,7,7,7,7,7,12,2,2,2,8,8,0,2024-01-07 20:46:00,0
5232,5233,5233,5233,2029,24,348,24,145,2029,203,24,126,121,119,24,24,348,203,28,28,0,24,4,4,4,4,3,6,2,2,2,5,5,1,2024-01-07 20:48:00,0
5226,5224,5224,5224,2023,24,248,24,145,2023,103,24,128,120,118,24,24,248,103,28,28,0,24,4,4,4,4,4,6,2,2,2,8,8,0,2024-01-07 20:50:00,0
5218,5220,5220,5220,2028,24,239,24,145,2028,94,24,122,119,119,24,24,239,94,28,28,6,24,4,4,4,4,4,0,2,2,2,3,3,0,2024-01-07 20:52:00,0
5242,5242,5242,5242,2029,24,258,24,149,2029,109,24,130,121,119,24,24,258,109,31,31,0,24,7,7,7,7,7,6,2,2,2,9,9,0,2024-01-07 20:54:00,0
5233,5232,5232,5232,2027,24,254,24,145,2027,109,24,126,118,118,24,24,254,109,28,28,4,24,4,4,4,4,4,0,2,2,2,8,8,0,2024-01-07 20:56:00,0
5198,5198,5198,5198,2009,22,360,22,144,2009,216,22,126,120,118,22,22,360,216,28,28,0,22,4,4,4,4,4,6,2,2,2,6,6,0,2024-01-07 20:58:00,0
5236,5237,5237,5237,2033,24,242,24,146,2033,96,24,130,121,119,24,24,242,96,28,28,0,24,4,4,4,4,3,6,2,2,2,9,9,1,2024-01-07 21:00:00,0
5207,5207,5207,5207,2014,24,444,24,148,2014,296,24,133,123,118,24,24,444,296,31,31,4,24,7,7,7,7,7,15,2,2,2,10,10,0,2024-01-07 21:02:00,0
5213,5209,5209,5209,2014,24,251,24,143,2014,108,24,124,119,118,24,24,251,108,27,27,0,24,3,3,3,3,3,3,2,2,2,5,5,0,2024-01-07 21:04:00,0
5273,5277,5277,5277,2031,24,282,24,146,2031,136,24,133,120,119,24,24,282,136,28,28,4,24,4,4,4,4,3,3,2,2,2,13,13,1,2024-01-07 21:06:00,0
5241,5260,5240,5240,2038,24,231,24,150,2038,81,24,137,121,119,24,24,231,81,32,32,0,24,8,8,8,8,8,6,2,2,2,16,16,0,2024-01-07 21:08:00,0
5255,5256,5256,5256,2036,24,253,24,145,2036,108,24,129,122,119,24,24,253,108,27,27,0,24,3,3,3,3,3,9,2,2,2,7,7,0,2024-01-07 21:10:00,0
5273,5273,5273,5273,2026,24,393,24,145,2026,248,24,128,119,118,24,24,393,248,28,28,4,24,4,4,4,4,4,3,2,2,2,9,9,0,2024-01-07 21:12:00,0
5250,5249,5249,5249,2029,24,265,24,145,2029,120,24,130,119,118,24,24,265,120,28,28,0,24,4,4,4,4,4,3,2,2,2,11,11,0,2024-01-07 21:14:00,0
5252,5254,5253,5253,2021,24,278,24,148,2021,130,24,135,123,119,24,24,278,130,31,31,0,24,7,7,7,7,6,12,2,2,2,12,12,1,2024-01-07 21:16:00,0
5224,5224,5224,5224,2025,24,242,24,145,2025,97,24,133,121,118,24,24,242,97,28,28,4,24,4,4,4,4,4,9,2,2,2,12,12,0,2024-01-07 21:18:00,0
5257,5257,5257,5257,2031,24,263,24,145,2031,118,24,133,121,119,24,24,263,118,28,28,0,24,4,4,4,4,3,6,2,2,2,12,12,1,2024-01-07 21:20:00,0
5177,5177,5177,5177,2000,24,252,24,144,2000,108,24,126,120,117,24,24,252,108,27,27,0,24,3,3,3,3,3,9,2,2,2,6,6,0,2024-01-07 21:22:00,0
5253,5253,5253,5253,2029,22,270,22,149,2029,121,22,130,121,118,22,22,270,121,32,32,0,22,8,8,8,8,8,9,2,2,2,9,9,0,2024-01-07 21:24:00,0
5275,5275,5275,5275,2039,24,265,24,145,2039,120,24,131,122,119,24,24,265,120,27,27,0,24,3,3,3,3,3,9,2,2,2,9,9,0,2024-01-07 21:26:00,0
5240,5240,5240,5240,2020,24,268,24,145,2020,123,24,126,120,118,24,24,268,123,28,28,1,24,4,4,4,4,4,6,2,2,2,6,6,0,2024-01-07 21:28:00,0
5258,5258,5258,5258,2026,24,273,24,148,2026,125,24,131,123,119,24,24,273,125,31,31,0,24,7,7,7,7,7,12,2,2,2,8,8,0,2024-01-07 21:30:00,0
5241,5241,5241,5241,2021,24,371,24,145,2021,226,24,128,120,118,24,24,371,226,28,28,3,24,4,4,4,4,3,6,2,2,2,8,8,1,2024-01-07 21:32:00,0
5226,5226,5226,5226,2025,24,250,24,145,2025,105,24,124,118,118,24,24,250,105,28,28,1,24,4,4,4,4,4,0,2,2,2,6,6,0,2024-01-07 21:34:00,0
5272,5271,5271,5271,2028,24,288,24,145,2028,143,24,126,121,120,24,24,288,143,28,28,0,24,4,4,4,4,3,3,2,2,2,5,5,1,2024-01-07 21:36:00,0
5239,5240,5240,5240,2026,24,256,24,149,2026,107,24,132,120,118,24,24,256,107,31,31,4,24,7,7,7,7,7,6,2,2,2,12,12,0,2024-01-07 21:38:00,0
5230,5230,5230,5230,2024,24,248,24,145,2024,103,24,133,123,119,24,24,248,103,28,28,0,24,4,4,4,4,4,12,2,2,2,10,10,0,2024-01-07 21:40:00,0
5233,5231,5231,5231,2011,24,276,24,143,2011,133,24,132,121,119,24,24,276,133,27,27,0,24,3,3,3,3,3,6,2,2,2,11,11,0,2024-01-07 21:42:00,0
5212,5214,5214,5214,2012,24,254,24,145,2012,109,24,126,119,117,24,24,254,109,28,28,4,24,4,4,4,4,4,6,2,2,2,7,7,0,2024-01-07 21:44:00,0
5227,5226,5226,5226,2027,24,259,24,148,2027,111,24,127,120,118,24,24,259,111,31,31,0,24,7,7,7,7,7,6,2,2,2,7,7,0,2024-01-07 21:46:00,0
5241,5242,5242,5242,2026,24,258,24,145,2026,113,24,129,119,118,24,24,258,113,28,28,4,24,4,4,4,4,3,3,2,2,2,10,10,1,2024-01-07 21:48:00,0
5203,5203,5203,5203,2014,22,242,22,145,2014,97,22,129,122,119,22,22,242,97,28,28,0,22,4,4,4,4,4,9,2,2,2,7,7,0,2024-01-07 21:50:00,0
5242,5241,5241,5241,2030,24,257,24,148,2030,109,24,128,122,119,24,24,257,109,31,31,0,24,7,7,7,7,7,9,2,2,2,6,6,0,2024-01-07 21:52:00,0
5239,5238,5238,5238,2029,24,256,24,145,2029,111,24,126,118,118,24,24,256,111,28,28,0,24,4,4,4,4,3,0,2,2,2,8,8,1,2024-01-07 21:54:00,0
5231,5232,5232,5232,2021,24,260,24,145,2021,115,24,124,119,118,24,24,260,115,28,28,1,24,4,4,4,4,4,3,2,2,2,5,5,0,2024-01-07 21:56:00,0
5270,5271,5271,5271,2032,24,276,24,146,2032,130,24,134,126,119,24,24,276,130,28,28,4,24,4,4,4,4,3,21,2,2,2,8,8,1,2024-01-07 21:58:00,0
5271,5271,5271,5271,2038,24,270,24,149,2038,121,24,129,122,119,24,24,270,121,31,31,0,24,7,7,7,7,7,9,2,2,2,7,7,0,2024-01-07 22:00:00,0
5233,5232,5232,5232,2021,24,553,24,145,2021,408,24,132,124,118,24,24,553,408,28,28,0,24,4,4,4,4,4,18,2,2,2,8,8,0,2024-01-07 22:02:00,0
5230,5230,5230,5230,2021,24,261,24,144,2021,117,24,123,120,119,24,24,261,117,27,27,4,24,3,3,3,3,3,3,2,2,2,3,3,0,2024-01-07 22:04:00,0
5246,5247,5247,5247,2021,24,281,24,149,2021,132,24,129,121,118,24,24,281,132,32,32,0,24,8,8,8,8,8,9,2,2,2,8,8,0,2024-01-07 22:06:00,0
5245,5245,5245,5245,2028,24,257,24,144,2028,113,24,128,120,118,24,24,257,113,27,27,1,24,3,3,3,3,3,6,2,2,2,8,8,0,2024-01-07 22:08:00,0
5204,5203,5203,5203,2007,24,259,24,143,2007,116,24,134,120,117,24,24,259,116,27,27,1,24,4,4,4,4,3,9,2,2,2,14,14,1,2024-01-07 22:10:00,0
5212,5212,5212,5212,2021,24,243,24,145,2021,98,24,126,120,119,24,24,243,98,28,28,0,24,4,4,4,4,4,3,2,2,2,6,6,0,2024-01-07 22:12:00,0
5220,5221,5221,5221,2022,24,253,24,148,2022,105,24,127,121,118,24,24,253,105,31,31,0,24,7,7,7,7,6,9,2,2,2,6,6,1,2024-01-07 22:14:00,0
5217,5217,5217,5217,2021,22,243,22,145,2021,98,22,129,121,118,22,22,243,98,28,28,0,22,4,4,4,4,4,9,2,2,2,8,8,0,2024-01-07 22:16:00,0
5273,5273,5273,5273,2034,24,367,24,146,2034,221,24,137,126,119,24,24,367,221,28,28,1,24,4,4,4,4,4,21,2,2,2,11,11,0,2024-01-07 22:18:00,0
5232,5231,5231,5231,2024,24,253,24,145,2024,108,24,126,121,118,24,24,253,108,28,28,4,24,3,3,3,3,3,9,2,2,2,5,5,0,2024-01-07 22:20:00,0
5219,5220,5220,5220,2021,24,251,24,149,2021,102,24,133,120,118,24,24,251,102,32,32,0,24,8,8,8,8,8,6,2,2,2,13,13,0,2024-01-07 22:22:00,0
5239,5238,5238,5238,2027,24,259,24,144,2027,115,24,125,119,118,24,24,259,115,27,27,2,24,3,3,3,3,3,3,2,2,2,6,6,0,2024-01-07 22:24:00,0
5234,5234,5234,5234,2023,24,260,24,145,2023,115,24,126,122,118,24,24,260,115,28,28,0,24,4,4,4,4,3,12,2,2,2,4,4,1,2024-01-07 22:26:00,0
5256,5256,5256,5256,2033,24,263,24,149,2033,114,24,127,118,118,24,24,263,114,31,31,0,24,7,7,7,7,7,0,2,2,2,9,9,0,2024-01-07 22:28:00,0
5241,5242,5242,5242,2031,24,258,24,145,2031,113,24,124,120,119,24,24,258,113,28,28,4,24,4,4,4,4,3,3,2,2,2,4,4,1,2024-01-07 22:30:00,0
5273,5273,5273,5273,2036,24,272,24,146,2036,126,24,128,119,118,24,24,272,126,28,28,0,24,4,4,4,4,4,3,2,2,2,9,9,0,2024-01-07 22:32:00,0
5198,5198,5198,5198,2008,24,258,24,143,2008,115,24,130,120,117,24,24,258,115,27,27,4,24,4,4,4,4,4,9,2,2,2,10,10,0,2024-01-07 22:34:00,0
5248,5248,5248,5248,2028,24,262,24,149,2028,113,24,129,122,119,24,24,262,113,31,31,0,24,7,7,7,7,7,9,2,2,2,7,7,0,2024-01-07 22:36:00,0
5266,5266,5266,5266,2034,24,265,24,145,2034,120,24,134,121,119,24,24,265,120,28,28,0,24,4,4,4,4,4,6,2,2,2,13,13,0,2024-01-07 22:38:00,0
5207,5206,5206,5206,2022,24,235,24,145,2022,90,24,131,121,118,24,24,235,90,28,28,4,24,4,4,4,4,3,9,2,2,2,10,10,1,2024-01-07 22:40:00,0
5217,5218,5218,5218,2010,22,273,22,144,2010,129,22,131,120,118,22,22,273,129,27,27,0,22,3,3,3,3,3,6,2,2,2,11,11,0,2024-01-07 22:42:00,0
5223,5223,5223,5223,2024,24,250,24,148,2024,102,24,126,124,119,24,24,250,102,31,31,0,24,7,7,7,7,7,15,2,2,2,2,2,0,2024-01-07 22:44:00,0
5242,5241,5241,5241,2031,24,250,24,145,2031,105,24,127,121,118,24,24,250,105,28,28,2,24,4,4,4,4,3,9,2,2,2,6,6,1,2024-01-07 22:46:00,0
5238,5238,5238,5238,2031,24,355,24,146,2031,209,24,122,121,119,24,24,355,209,28,28,0,24,4,4,4,4,4,6,2,2,2,1,1,0,2024-01-07 22:48:00,0
5236,5237,5237,5237,2022,24,317,24,149,2022,168,24,124,119,118,24,24,317,117,32,32,0,24,8,8,7,7,7,3,2,2,2,5,5,0,2024-01-07 22:50:00,52
5225,5225,5225,5225,2021,24,258,24,145,2021,113,24,125,120,118,24,24,258,113,28,28,0,24,4,4,4,4,4,6,2,2,2,5,5,0,2024-01-07 22:52:00,0
5239,5238,5238,5238,2032,24,245,24,145,2032,100,24,129,121,118,24,24,245,100,28,28,0,24,4,4,4,4,4,9,2,2,2,8,8,0,2024-01-07 22:54:00,0
5258,5259,5259,5259,2045,24,242,24,146,2045,96,24,128,121,120,24,24,242,96,27,27,5,24,3,3,3,3,3,3,2,2,2,7,7,0,2024-01-07 22:56:00,0
5202,5202,5202,5202,2014,24,256,24,148,2014,108,24,127,119,118,24,24,256,108,32,32,0,24,8,8,8,8,8,3,2,2,2,8,8,0,2024-01-07 22:58:00,0
5263,5263,5263,5263,2034,24,267,24,145,2034,122,24,126,119,118,24,24,267,122,27,27,2,24,3,3,3,3,3,3,2,2,2,7,7,0,2024-01-07 23:00:00,0
5219,5218,5218,5218,2017,24,348,24,145,2017,203,24,134,123,120,24,24,348,203,28,28,0,24,4,4,4,4,3,9,2,2,2,11,11,1,2024-01-07 23:02:00,0
5239,5240,5240,5240,2023,24,265,24,148,2023,117,24,125,119,118,24,24,265,117,31,31,0,24,7,7,7,7,7,3,2,2,2,6,6,0,2024-01-07 23:04:00,0
5208,5208,5208,5208,2026,24,222,24,145,2026,77,24,136,122,120,24,24,222,77,28,28,0,24,4,4,4,4,3,6,2,2,2,14,14,1,2024-01-07 23:06:00,0
5260,5258,5258,5258,2037,23,258,22,146,2037,112,22,127,123,118,22,22,258,112,28,28,1,22,4,4,4,4,4,15,2,2,2,4,4,0,2024-01-07 23:08:00,0
5265,5265,5265,5265,2019,23,288,24,145,2019,143,24,133,122,119,24,24,288,143,28,28,2,24,4,4,4,4,4,9,2,2,2,11,11,0,2024-01-07 23:10:00,0
5241,5243,5243,5243,2025,24,260,24,148,2025,112,24,134,122,118,24,24,260,112,31,31,0,24,7,7,7,7,7,12,2,2,2,12,12,0,2024-01-07 23:12:00,0
5208,5207,5207,5207,2015,24,241,24,145,2015,96,24,135,125,120,24,24,241,96,28,28,0,24,4,4,4,4,4,15,2,2,2,10,10,0,2024-01-07 23:14:00,0
5233,5232,5232,5232,2026,24,249,24,145,2026,104,24,131,122,118,24,24,249,104,28,28,2,24,4,4,4,4,3,12,2,2,2,9,9,1,2024-01-07 23:16:00,0
5260,5261,5261,5261,2029,24,373,24,144,2029,229,24,128,121,119,24,24,373,229,27,27,0,24,3,3,3,3,3,6,2,2,2,7,7,0,2024-01-07 23:18:00,0
5219,5220,5220,5220,2017,24,252,24,148,2017,104,24,129,119,118,24,24,252,104,31,31,0,24,7,7,7,7,7,3,2,2,2,10,10,0,2024-01-07 23:20:00,0
5204,5204,5204,5204,2008,24,265,24,145,2008,120,24,130,121,117,24,24,265,120,28,28,2,24,4,4,4,4,3,12,2,2,2,9,9,1,2024-01-07 23:22:00,0
5234,5234,5234,5234,2029,24,248,24,145,2029,103,24,126,121,119,24,24,248,103,28,28,0,24,4,4,4,4,4,6,2,2,2,5,5,0,2024-01-07 23:24:00,0
5238,5236,5236,5236,2024,24,263,24,148,2024,115,24,129,118,118,24,24,263,115,31,31,4,24,7,7,7,7,7,0,2,2,2,11,11,0,2024-01-07 23:26:00,0
5252,5254,5254,5254,2033,24,257,24,145,2033,112,24,132,122,118,24,24,257,112,28,28,0,24,4,4,4,4,4,12,2,2,2,10,10,0,2024-01-07 23:28:00,0
5243,5241,5241,5241,2031,24,253,24,146,2031,107,24,130,121,119,24,24,253,107,28,28,0,24,4,4,4,4,4,6,2,2,2,9,9,0,2024-01-07 23:30:00,0
5241,5242,5242,5242,2028,24,244,24,145,2028,99,24,135,122,120,24,24,244,99,28,28,0,24,4,4,4,4,3,6,2,2,2,13,13,1,2024-01-07 23:32:00,0
5249,5250,5250,5250,2027,22,268,22,148,2027,120,22,135,124,118,22,22,268,120,31,31,0,22,7,7,7,7,7,18,2,2,2,11,11,0,2024-01-07 23:34:00,0
5249,5249,5249,5249,2030,24,258,24,145,2030,113,24,129,119,118,24,24,258,113,27,27,3,24,3,3,3,3,3,3,2,2,2,10,10,0,2024-01-07 23:36:00,0
5285,5285,5285,5285,2036,24,380,24,145,2036,235,24,132,121,120,24,24,380,235,28,28,0,24,4,4,4,4,3,3,2,2,2,11,11,1,2024-01-07 23:38:00,0
5231,5229,5229,5229,2012,24,279,24,145,2012,134,24,129,119,118,24,24,279,134,28,28,0,24,4,4,4,4,4,3,2,2,2,10,10,0,2024-01-07 23:40:00,0
5174,5176,5176,5176,1998,24,253,24,146,1998,107,24,134,119,117,24,24,253,107,31,31,0,24,7,7,7,7,7,6,2,2,2,15,15,0,2024-01-07 23:42:00,0
5255,5256,5255,5255,2031,24,267,24,146,2031,121,24,127,125,119,24,24,267,121,28,28,0,24,4,4,4,4,4,18,2,2,2,2,2,0,2024-01-07 23:44:00,0
5260,5260,5260,5260,2032,24,262,24,145,2032,117,24,132,122,118,24,24,262,117,28,28,2,24,4,4,4,4,4,12,2,2,2,10,10,0,2024-01-07 23:46:00,0
5240,5240,5240,5240,2034,24,240,24,149,2034,91,24,135,122,118,24,24,240,91,31,31,1,24,7,7,7,7,6,12,2,2,2,13,13,1,2024-01-07 23:48:00,0
5240,5240,5240,5240,2020,24,264,24,145,2020,119,24,129,120,118,24,24,264,119,28,28,0,24,4,4,4,4,4,6,2,2,2,9,9,0,2024-01-07 23:50:00,0
5234,5233,5233,5233,2027,24,353,24,145,2027,208,24,129,122,118,24,24,353,208,28,28,2,24,4,4,4,4,4,12,2,2,2,7,7,0,2024-01-07 23:52:00,0
5260,5261,5261,5261,2037,24,263,24,146,2037,117,24,126,122,119,24,24,263,117,28,28,0,24,4,4,4,4,4,9,2,2,2,4,4,0,2024-01-07 23:54:00,0
5243,5243,5243,5243,2028,24,264,24,148,2028,116,24,124,121,120,24,24,264,116,31,31,0,24,7,7,7,7,7,3,2,2,2,3,3,0,2024-01-07 23:56:00,0
5222,5221,5221,5221,2024,24,245,24,145,2024,100,24,128,120,118,24,24,245,100,28,28,2,24,4,4,4,4,4,6,2,2,2,8,8,0,2024-01-07 23:58:00,0
5279,5280,5280,5280,2026,22,286,22,145,2026,141,22,140,122,120,22,22,286,141,28,28,0,22,4,4,4,4,3,6,2,2,2,18,18,1,2024-01-08 00:00:00,0
5235,5234,5234,5234,2023,24,258,24,149,2023,109,24,131,120,118,24,24,258,109,31,31,2,24,7,7,7,7,7,6,2,2,2,11,11,0,2024-01-08 00:02:00,0
5195,5195,5195,5195,2009,24,260,24,143,2009,117,24,121,118,117,24,24,260,117,27,27,0,24,3,3,3,3,3,3,2,2,2,3,3,0,2024-01-08 00:04:00,0
5200,5201,5201,5201,2011,24,250,24,145,2011,105,24,126,119,118,24,24,250,105,28,28,0,24,4,4,4,4,3,3,2,2,2,7,7,1,2024-01-08 00:06:00,0
5253,5252,5252,5252,2030,24,255,24,145,2030,110,24,138,123,118,24,24,255,110,28,28,0,24,4,4,4,4,4,15,2,2,2,15,15,0,2024-01-08 00:08:00,0
5264,5265,5265,5265,2027,24,282,24,148,2027,134,24,133,124,119,24,24,282,134,31,31,1,24,7,7,7,7,7,15,2,2,2,9,9,0,2024-01-08 00:10:00,0
5238,5237,5237,5237,2017,24,270,24,145,2017,125,24,130,120,119,24,24,270,125,28,28,2,24,4,4,4,4,4,3,2,2,2,10,10,0,2024-01-08 00:12:00,0
5240,5240,5240,5240,2032,24,254,24,146,2032,108,24,126,118,118,24,24,254,108,28,28,0,24,4,4,4,4,4,0,2,2,2,8,8,0,2024-01-08 00:14:00,0
5232,5233,5233,5233,2026,24,246,24,145,2026,101,24,130,120,118,24,24,246,101,28,28,0,24,4,4,4,4,3,6,2,2,2,10,10,1,2024-01-08 00:16:00,0
5244,5242,5242,5242,2029,24,259,24,148,2029,111,24,131,119,118,24,24,259,111,31,31,2,24,7,7,7,7,7,3,2,2,2,12,12,0,2024-01-08 00:18:00,0
5246,5247,5247,5247,2019,24,275,24,144,2019,131,24,138,127,118,24,24,275,131,27,27,0,24,3,3,3,3,3,27,2,2,2,11,11,0,2024-01-08 00:20:00,0
5180,5200,5181,5181,1995,24,366,24,143,1995,223,24,131,121,117,24,24,366,223,28,28,0,24,4,4,4,4,3,12,2,2,2,10,10,1,2024-01-08 00:22:00,0
5244,5244,5244,5244,2024,22,280,22,149,2024,131,22,132,121,118,22,22,280,131,32,32,0,22,8,8,8,8,8,9,2,2,2,11,11,0,2024-01-08 00:24:00,0
5174,5172,5172,5172,2032,24,193,24,145,2032,48,24,120,119,119,24,24,193,48,27,27,0,24,3,3,3,3,3,0,2,2,2,1,1,0,2024-01-08 00:26:00,0
5058,5060,5060,5060,2003,24,145,24,144,2003,1,24,117,117,117,24,24,145,1,28,28,1,24,4,4,4,4,4,0,2,2,2,0,0,0,2024-01-08 00:28:00,0
5105,5105,5105,5105,2022,24,148,24,145,2022,3,24,118,118,118,24,24,148,3,28,28,0,24,4,4,4,4,4,0,2,2,2,0,0,0,2024-01-08 00:30:00,0
5241,5240,5240,5240,2022,24,287,24,148,2022,139,24,118,118,118,24,24,287,139,31,31,0,24,7,7,7,7,6,0,2,2,2,0,0,1,2024-01-08 00:32:00,0
5379,5380,5380,5380,2025,24,414,24,145,2025,269,24,118,118,118,24,24,414,269,28,28,4,24,4,4,4,4,4,0,2,2,2,0,0,0,2024-01-08 00:34:00,0
5429,5429,5429,5429,2020,24,474,24,144,2020,330,24,118,118,118,24,24,474,330,27,27,0,24,3,3,3,3,3,0,2,2,2,0,0,0,2024-01-08 00:36:00,0
5407,5406,5406,5406,2031,24,427,24,145,2031,282,24,118,118,118,24,24,427,282,28,28,0,24,4,4,4,4,3,0,2,2,2,0,0,1,2024-01-08 00:38:00,0
5416,5416,5416,5416,2030,24,446,24,150,2030,296,24,118,118,118,24,24,446,296,32,32,0,24,8,8,8,8,8,0,2,2,2,0,0,0,2024-01-08 00:40:00,0
5448,5448,5448,5448,2009,24,510,24,143,2009,367,24,118,118,118,24,24,510,367,27,27,0,24,3,3,3,3,3,0,2,2,2,0,0,0,2024-01-08 00:42:00,0
5635,5635,5635,5635,2019,24,684,24,145,2019,539,24,118,118,118,24,24,684,539,28,28,5,24,4,4,4,4,4,0,2,2,2,0,0,0,2024-01-08 00:44:00,0
5699,5699,5699,5699,2011,24,762,24,147,2011,615,24,118,118,118,24,24,762,615,31,31,0,24,7,7,7,7,7,0,2,2,2,0,0,0,2024-01-08 00:46:00,0
5888,5887,5887,5887,2007,22,970,22,144,2007,826,22,117,117,117,22,22,970,826,28,28,3,22,4,4,4,4,3,0,2,2,2,0,0,1,2024-01-08 00:48:00,0
5928,5930,5930,5930,2025,24,958,24,146,2025,812,24,118,118,118,24,24,958,812,28,28,0,24,4,4,4,4,4,0,2,2,2,0,0,0,2024-01-08 00:50:00,0
5373,5373,5373,5373,2026,24,406,24,145,2026,261,24,118,118,118,24,24,406,261,28,28,0,24,4,4,4,4,4,0,2,2,2,0,0,0,2024-01-08 00:52:00,0
5246,5246,5246,5246,2014,24,306,24,148,2014,158,24,118,118,118,24,24,306,158,31,31,2,24,7,7,7,7,7,0,2,2,2,0,0,0,2024-01-08 00:54:00,0
5259,5258,5258,5258,2018,24,312,24,145,2018,167,24,118,118,118,24,24,312,167,28,28,0,24,4,4,4,4,4,0,2,2,2,0,0,0,2024-01-08 00:56:00,0
5268,5288,5268,5268,2019,24,309,24,145,2019,164,24,118,118,118,24,24,309,164,28,28,0,24,4,4,4,4,4,0,2,2,2,0,0,0,2024-01-08 00:58:00,0
5136,5137,5137,5137,2021,24,179,24,145,2021,34,24,118,118,118,24,24,179,34,28,28,0,24,4,4,4,4,3,0,2,2,2,0,0,1,2024-01-08 01:00:00,0
5174,5174,5174,5174,2019,24,420,24,148,2019,272,24,118,118,118,24,24,420,272,31,31,0,24,7,7,7,7,7,0,2,2,2,0,0,0,2024-01-08 01:02:00,0
5242,5242,5242,5242,2016,24,392,24,144,2016,248,24,118,118,118,24,24,392,248,27,27,3,24,3,3,3,3,3,0,2,2,2,0,0,0,2024-01-08 01:04:00,0
5277,5277,5277,5277,2016,24,332,24,145,2016,187,24,118,118,118,24,24,332,187,28,28,0,24,4,4,4,4,3,0,2,2,2,0,0,1,2024-01-08 01:06:00,0
5773,5773,5773,5773,1995,24,879,24,146,1995,733,24,117,117,117,24,24,879,733,31,31,0,24,8,8,8,8,8,0,2,2,2,0,0,0,2024-01-08 01:08:00,0
5326,5326,5326,5326,2031,23,349,23,145,2031,204,23,118,118,118,23,23,349,204,27,27,3,23,3,3,3,3,3,0,2,2,2,0,0,0,2024-01-08 01:10:00,0
5329,5329,5329,5329,2025,23,465,23,145,2025,320,23,118,118,118,23,23,465,320,28,28,0,23,4,4,4,4,4,0,2,2,2,0,0,0,2024-01-08 01:12:00,0
5230,5230,5230,5230,2021,24,271,24,146,2021,125,24,119,119,119,24,24,271,125,28,28,2,24,4,4,4,4,4,0,2,2,2,0,0,0,2024-01-08 01:14:00,0
5179,5180,5179,5179,2020,24,227,24,148,2020,79,24,118,118,118,24,24,227,79,31,31,0,24,7,7,7,7,6,0,2,2,2,0,0,1,2024-01-08 01:16:00,0
5142,5141,5140,5140,2027,24,172,24,145,2027,27,24,118,118,118,24,24,172,27,28,28,0,24,4,4,4,4,4,0,2,2,2,0,0,0,2024-01-08 01:18:00,0
5113,5115,5115,5115,2018,24,159,24,145,2018,14,24,118,118,118,24,24,159,14,28,28,2,24,4,4,4,4,4,0,2,2,2,0,0,0,2024-01-08 01:20:00,0
5104,5104,5104,5104,2017,24,148,24,145,2017,3,24,118,118,118,24,24,148,3,27,27,0,24,3,3,3,3,3,0,2,2,2,0,0,0,2024-01-08 01:22:00,0
5124,5124,5124,5124,2027,24,161,24,149,2027,12,24,118,118,118,24,24,161,12,32,32,3,24,8,8,8,8,8,0,2,2,2,0,0,0,2024-01-08 01:24:00,0
5132,5132,5132,5132,2031,24,153,24,145,2031,8,24,119,119,119,24,24,153,8,27,27,1,24,3,3,3,3,3,0,2,2,2,0,0,0,2024-01-08 01:26:00,0
5084,5083,5083,5083,2014,24,146,24,144,2014,2,24,117,117,117,24,24,146,2,28,28,0,24,4,4,4,4,3,0,2,2,2,0,0,1,2024-01-08 01:28:00,0
5108,5108,5108,5108,2019,24,150,24,146,2019,4,24,118,118,118,24,24,150,4,28,28,2,24,4,4,4,4,4,0,2,2,2,0,0,0,2024-01-08 01:30:00,0
5104,5105,5105,5105,2015,24,153,24,148,2015,5,24,118,118,118,24,24,153,5,31,31,0,24,7,7,7,7,6,0,2,2,2,0,0,1,2024-01-08 01:32:00,0
5096,5094,5094,5094,2014,23,149,23,145,2014,4,23,118,118,118,23,23,149,4,28,28,0,23,4,4,4,4,4,0,2,2,2,0,0,0,2024-01-08 01:34:00,0
5074,5076,5076,5076,2001,23,145,23,145,2001,0,23,118,118,118,23,23,145,0,28,28,4,23,4,4,4,4,4,0,2,2,2,0,0,0,2024-01-08 01:36:00,0
5086,5086,5086,5086,2007,24,149,24,148,2007,1,24,118,118,118,24,24,149,1,31,31,2,24,7,7,7,7,7,0,2,2,2,0,0,0,2024-01-08 01:38:00,0
5102,5102,5102,5102,2018,24,167,24,167,2018,0,24,118,118,118,24,24,167,0,50,50,2,24,15,4,4,4,4,0,2,2,2,0,0,0,2024-01-08 01:40:00,97
5099,5097,5097,5097,2012,24,145,24,144,2012,1,24,118,118,118,24,24,145,1,27,27,0,24,3,3,3,3,3,0,2,2,2,0,0,0,2024-01-08 01:42:00,0
4873,4875,4875,4875,1924,24,147,24,145,1925,2,24,118,118,118,24,24,147,2,28,28,0,24,4,4,4,4,3,0,2,2,2,0,0,1,2024-01-08 01:44:00,6
4398,4398,4398,4398,1731,24,148,24,148,1731,0,24,118,118,118,24,24,148,0,31,31,2,24,7,7,7,7,7,0,2,2,2,0,0,0,2024-01-08 01:46:00,0
4436,4436,4436,4436,1748,24,249,24,147,1748,102,24,119,119,119,24,24,249,102,28,28,0,24,4,4,4,4,3,0,2,2,2,0,0,1,2024-01-08 01:48:00,0
4374,4373,4373,4373,1721,24,144,24,144,1721,0,24,117,117,117,24,24,144,0,28,28,4,24,4,4,4,4,4,0,2,2,2,0,0,0,2024-01-08 01:50:00,0
4404,4405,4405,4405,1730,24,145,24,145,1730,0,24,118,118,118,24,24,145,0,28,28,0,24,4,4,4,4,4,0,2,2,2,0,0,0,2024-01-08 01:52:00,0
4434,4434,4434,4434,1744,24,152,24,149,1744,3,24,118,118,118,24,24,152,3,31,31,0,24,7,7,7,7,6,0,2,2,2,0,0,1,2024-01-08 01:54:00,0
4415,4414,4414,4414,1734,24,145,24,145,1734,0,24,118,118,118,24,24,145,0,28,28,4,24,4,4,4,4,4,0,2,2,2,0,0,0,2024-01-08 01:56:00,0
4402,4403,4403,4403,1730,23,147,23,145,1730,2,23,118,118,118,23,23,147,2,28,28,0,23,4,4,4,4,4,0,2,2,2,0,0,0,2024-01-08 01:58:00,0
4404,4404,4404,4404,1730,23,148,23,148,1730,0,23,118,118,118,23,23,148,0,31,31,0,23,7,7,7,7,7,0,2,2,2,0,0,0,2024-01-08 02:00:00,0
4401,4401,4401,4401,1729,24,145,24,145,1729,0,24,118,118,118,24,24,145,0,28,28,0,24,4,4,4,4,4,0,2,2,2,0,0,0,2024-01-08 02:02:00,0
4420,4420,4420,4420,1738,24,144,24,144,1738,0,24,118,118,118,24,24,144,0,27,27,1,24,3,3,3,3,3,0,2,2,2,0,0,0,2024-01-08 02:04:00,0
4418,4418,4418,4418,1738,24,146,24,146,1738,0,24,119,119,119,24,24,146,0,28,28,4,24,4,4,4,4,3,0,2,2,2,0,0,1,2024-01-08 02:06:00,0
4400,4400,4400,4400,1729,24,248,24,147,1729,101,24,118,118,118,24,24,248,101,31,31,0,24,7,7,7,7,7,0,2,2,2,0,0,0,2024-01-08 02:08:00,0
4413,4413,4413,4413,1736,24,145,24,145,1736,0,24,118,118,118,24,24,145,0,28,28,0,24,4,4,4,4,3,0,2,2,2,0,0,1,2024-01-08 02:10:00,0
4367,4365,4365,4365,1717,24,144,24,144,1717,0,24,117,117,117,24,24,144,0,28,28,2,24,4,4,4,4,4,0,2,2,2,0,0,0,2024-01-08 02:12:00,0
4431,4433,4433,4433,1744,24,146,24,146,1744,0,24,118,118,118,24,24,146,0,28,28,0,24,4,4,4,4,4,0,2,2,2,0,0,0,2024-01-08 02:14:00,0
5077,5077,5077,5077,1997,28,170,28,170,1997,0,28,135,135,135,28,28,170,0,35,35,4,28,7,7,7,7,7,0,3,3,3,0,0,0,2024-01-08 02:16:00,0
4420,4418,4418,4418,1738,24,146,24,146,1738,0,24,119,119,119,24,24,146,0,28,28,0,24,4,4,4,4,4,0,2,2,2,0,0,0,2024-01-08 02:18:00,0
4418,4420,4420,4420,1740,24,145,24,145,1740,0,24,118,118,118,24,24,145,0,28,28,0,24,4,4,4,4,3,0,2,2,2,0,0,1,2024-01-08 02:20:00,0
4370,4369,4369,4369,1715,24,248,24,147,1715,101,24,117,117,117,24,24,248,101,31,31,4,24,7,7,7,7,7,0,2,2,2,0,0,0,2024-01-08 02:22:00,0
4406,4407,4407,4407,1734,22,144,22,144,1734,0,22,118,118,118,22,22,144,0,27,27,0,22,3,3,3,3,3,0,2,2,2,0,0,0,2024-01-08 02:24:00,0
4420,4420,4420,4420,1739,24,145,24,145,1739,0,24,119,119,119,24,24,145,0,28,28,4,24,4,4,4,4,3,0,2,2,2,0,0,1,2024-01-08 02:26:00,0
4420,4420,4420,4420,1739,24,146,24,146,1739,0,24,118,118,118,24,24,146,0,28,28,0,24,4,4,4,4,4,0,2,2,2,0,0,0,2024-01-08 02:28:00,0
4416,4416,4416,4416,1736,24,148,24,148,1736,0,24,118,118,118,24,24,148,0,31,31,0,24,7,7,7,7,7,0,2,2,2,0,0,0,2024-01-08 02:30:00,0
4388,4388,4388,4388,1728,24,144,24,144,1728,0,24,118,118,118,24,24,144,0,28,28,2,24,4,4,4,4,4,0,2,2,2,0,0,0,2024-01-08 02:32:00,0
4429,4428,4428,4428,1745,24,146,24,146,1745,0,24,118,118,118,24,24,146,0,28,28,0,24,4,4,4,4,4,0,2,2,2,0,0,0,2024-01-08 02:34:00,0
4416,4418,4417,4417,1735,24,147,24,147,1735,0,24,118,118,118,24,24,147,0,30,30,0,24,6,6,6,6,5,0,2,2,2,0,0,1,2024-01-08 02:36:00,0
4406,4406,4406,4406,1732,24,146,24,146,1732,0,24,118,118,118,24,24,146,0,29,29,0,24,5,5,5,5,5,0,2,2,2,0,0,0,2024-01-08 02:38:00,0
4402,4404,4402,4402,1728,24,145,24,145,1728,0,24,118,118,118,24,24,145,0,28,28,1,24,4,4,4,4,4,0,2,2,2,0,0,0,2024-01-08 02:40:00,0
4384,4384,4384,4384,1722,24,144,24,144,1722,0,24,118,118,118,24,24,144,0,28,28,4,24,4,4,4,4,3,0,2,2,2,0,0,1,2024-01-08 02:42:00,0
4411,4410,4410,4410,1735,24,148,24,148,1735,0,24,118,118,118,24,24,148,0,31,31,0,24,7,7,7,7,7,0,2,2,2,0,0,0,2024-01-08 02:44:00,0
4422,4423,4423,4423,1740,24,145,24,145,1740,0,24,118,118,118,24,24,145,0,27,27,1,24,3,3,3,3,3,0,2,2,2,0,0,0,2024-01-08 02:46:00,0
4419,4419,4419,4419,1740,24,145,24,145,1740,0,24,118,118,118,24,24,145,0,28,28,1,24,4,4,4,4,3,0,2,2,2,0,0,1,2024-01-08 02:48:00,0
4427,4427,4427,4427,1745,23,146,23,146,1745,0,23,119,119,119,23,23,146,0,28,28,0,23,4,4,4,4,4,0,2,2,2,0,0,0,2024-01-08 02:50:00,0
4417,4417,4417,4417,1738,23,249,23,148,1738,101,23,118,118,118,23,23,249,101,31,31,0,23,7,7,7,7,7,0,2,2,2,0,0,0,2024-01-08 02:52:00,0
4422,4422,4422,4422,1739,24,145,24,145,1739,0,24,118,118,118,24,24,145,0,28,28,0,24,4,4,4,4,3,0,2,2,2,0,0,1,2024-01-08 02:54:00,0
4390,4390,4390,4390,1726,24,145,24,145,1726,0,24,117,117,117,24,24,145,0,28,28,1,24,4,4,4,4,4,0,2,2,2,0,0,0,2024-01-08 02:56:00,0
4412,4412,4412,4412,1734,24,249,24,148,1734,101,24,118,118,118,24,24,249,101,31,31,4,24,7,7,7,7,6,0,2,2,2,0,0,1,2024-01-08 02:58:00,0
4410,4410,4410,4410,1735,24,145,24,145,1735,0,24,119,119,119,24,24,145,0,28,28,0,24,4,4,4,4,4,0,2,2,2,0,0,0,2024-01-08 03:00:00,0
4375,4375,4375,4375,1721,24,448,24,145,1721,303,24,117,117,117,24,24,448,303,28,28,0,24,4,4,4,4,4,0,2,2,2,0,0,0,2024-01-08 03:02:00,0
4445,4445,4445,4445,1750,24,246,24,145,1750,101,24,119,119,119,24,24,246,101,27,27,0,24,3,3,3,3,3,0,2,2,2,0,0,0,2024-01-08 03:04:00,0
4427,4426,4426,4426,1744,24,149,24,149,1744,0,24,118,118,118,24,24,149,0,32,32,0,24,8,8,8,8,8,0,2,2,2,0,0,0,2024-01-08 03:06:00,0
4413,4414,4414,4414,1734,24,245,24,144,1734,101,24,118,118,118,24,24,245,101,27,27,3,24,3,3,3,3,3,0,2,2,2,0,0,0,2024-01-08 03:08:00,0
4399,4399,4399,4399,1728,24,145,24,145,1728,0,24,118,118,118,24,24,145,0,28,28,0,24,4,4,4,4,3,0,2,2,2,0,0,1,2024-01-08 03:10:00,0
4409,4409,4409,4409,1734,24,246,24,145,1734,101,24,118,118,118,24,24,246,101,28,28,0,24,4,4,4,4,4,0,2,2,2,0,0,0,2024-01-08 03:12:00,0
4442,4442,4442,4442,1750,24,149,24,149,1750,0,24,119,119,119,24,24,149,0,31,31,0,24,7,7,7,7,6,0,2,2,2,0,0,1,2024-01-08 03:14:00,0
4416,4417,4416,4416,1740,23,145,23,145,1740,0,23,118,118,118,23,23,145,0,28,28,1,23,4,4,4,4,4,0,2,2,2,0,0,0,2024-01-08 03:16:00,0
4410,4410,4410,4410,1737,23,145,23,145,1737,0,23,118,118,118,23,23,145,0,28,28,2,23,4,4,4,4,4,0,2,2,2,0,0,0,2024-01-08 03:18:00,0
4368,4368,4368,4368,1716,24,147,24,147,1716,0,24,117,117,117,24,24,147,0,31,31,0,24,7,7,7,7,7,0,2,2,2,0,0,0,2024-01-08 03:20:00,0
4392,4392,4392,4392,1725,24,145,24,145,1725,0,24,118,118,118,24,24,145,0,28,28,0,24,4,4,4,4,4,0,2,2,2,0,0,0,2024-01-08 03:22:00,0
4396,4396,4396,4396,1728,24,144,24,144,1728,0,24,118,118,118,24,24,144,0,27,27,4,24,3,3,3,3,3,0,2,2,2,0,0,0,2024-01-08 03:24:00,0
4393,4392,4392,4392,1726,24,144,24,144,1726,0,24,118,118,118,24,24,144,0,28,28,0,24,4,4,4,4,3,0,2,2,2,0,0,1,2024-01-08 03:26:00,0
4438,4438,4438,4438,1746,24,149,24,149,1746,0,24,118,118,118,24,24,149,0,31,31,0,24,7,7,7,7,7,0,2,2,2,0,0,0,2024-01-08 03:28:00,0
4421,4422,4422,4422,1738,24,146,24,146,1738,0,24,119,119,119,24,24,146,0,28,28,0,24,4,4,4,4,3,0,2,2,2,0,0,1,2024-01-08 03:30:00,0
4419,4419,4419,4419,1741,24,145,24,145,1741,0,24,118,118,118,24,24,145,0,28,28,1,24,4,4,4,4,4,0,2,2,2,0,0,0,2024-01-08 03:32:00,0
4420,4419,4419,4419,1738,24,145,24,145,1738,0,24,118,118,118,24,24,145,0,28,28,2,24,4,4,4,4,4,0,2,2,2,0,0,0,2024-01-08 03:34:00,0
4427,4428,4428,4428,1743,24,149,24,149,1743,0,24,119,119,119,24,24,149,0,31,31,0,24,7,7,7,7,6,0,2,2,2,0,0,1,2024-01-08 03:36:00,0
4426,4425,4425,4425,1740,24,146,24,146,1740,0,24,118,118,118,24,24,146,0,28,28,0,24,4,4,4,4,4,0,2,2,2,0,0,0,2024-01-08 03:38:00,0
4404,4405,4405,4405,1731,24,145,24,145,1731,0,24,118,118,118,24,24,145,0,28,28,0,24,4,4,4,4,4,0,2,2,2,0,0,0,2024-01-08 03:40:00,0
4407,4407,4407,4407,1731,23,148,23,148,1731,0,23,118,118,118,23,23,148,0,31,31,0,23,7,7,7,7,7,0,2,2,2,0,0,0,2024-01-08 03:42:00,0
4403,4403,4403,4403,1737,23,144,23,144,1737,0,23,118,118,118,23,23,144,0,27,27,5,23,4,4,4,4,4,0,2,2,2,0,0,0,2024-01-08 03:44:00,0
4425,4423,4423,4423,1744,24,145,24,145,1744,0,24,119,119,119,24,24,145,0,27,27,0,24,3,3,3,3,3,0,2,2,2,0,0,0,2024-01-08 03:46:00,0
4400,4402,4402,4402,1729,24,144,24,144,1729,0,24,117,117,117,24,24,144,0,28,28,0,24,4,4,4,4,3,0,2,2,2,0,0,1,2024-01-08 03:48:00,0
4418,4418,4418,4418,1738,24,149,24,149,1738,0,24,119,119,119,24,24,149,0,31,31,4,24,7,7,7,7,7,0,2,2,2,0,0,0,2024-01-08 03:50:00,0
4421,4420,4420,4420,1739,24,197,24,146,1739,51,24,118,118,118,24,24,197,0,29,29,0,24,5,5,4,4,4,0,2,2,2,0,0,0,2024-01-08 03:52:00,52
4422,4423,4423,4423,1741,24,146,24,146,1741,0,24,118,118,118,24,24,146,0,28,28,4,24,4,4,4,4,4,0,2,2,2,0,0,0,2024-01-08 03:54:00,0
4415,4415,4415,4415,1737,24,144,24,144,1737,0,24,119,119,119,24,24,144,0,27,27,0,24,3,3,3,3,3,0,2,2,2,0,0,0,2024-01-08 03:56:00,0
4428,4429,4428,4428,1745,24,149,24,149,1745,0,24,118,118,118,24,24,149,0,32,32,0,24,8,8,8,8,8,0,2,2,2,0,0,0,2024-01-08 03:58:00,0
4421,4421,4421,4421,1739,24,145,24,145,1739,0,24,118,118,118,24,24,145,0,27,27,4,24,3,3,3,3,3,0,2,2,2,0,0,0,2024-01-08 04:00:00,0
4404,4404,4404,4404,1730,24,347,24,145,1730,202,24,118,118,118,24,24,347,202,28,28,0,24,4,4,4,4,3,0,2,2,2,0,0,1,2024-01-08 04:02:00,0
4429,4430,4429,4429,1743,24,250,24,149,1743,101,24,119,119,119,24,24,250,101,31,31,4,24,7,7,7,7,7,0,2,2,2,0,0,0,2024-01-08 04:04:00,0
4413,4413,4413,4413,1736,24,146,24,146,1736,0,24,118,118,118,24,24,146,0,29,29,0,24,4,4,4,4,3,0,2,2,2,0,0,1,2024-01-08 04:06:00,0
4383,4383,4383,4383,1726,22,143,22,143,1726,0,22,117,117,117,22,22,143,0,27,27,0,22,4,4,4,4,4,0,2,2,2,0,0,0,2024-01-08 04:08:00,0
4416,4416,4416,4416,1736,24,146,24,146,1736,0,24,119,119,119,24,24,146,0,28,28,4,24,4,4,4,4,4,0,2,2,2,0,0,0,2024-01-08 04:10:00,0
4440,4438,4438,4438,1749,24,148,24,148,1749,0,24,118,118,118,24,24,148,0,31,31,0,24,7,7,7,7,7,0,2,2,2,0,0,0,2024-01-08 04:12:00,0
4410,4412,4412,4412,1734,24,146,24,146,1734,0,24,118,118,118,24,24,146,0,28,28,0,24,4,4,4,4,4,0,2,2,2,0,0,0,2024-01-08 04:14:00,0
4432,4431,4431,4431,1747,24,145,24,145,1747,0,24,119,119,119,24,24,145,0,28,28,2,24,4,4,4,4,3,0,2,2,2,0,0,1,2024-01-08 04:16:00,0
4418,4420,4419,4419,1736,24,250,24,149,1736,101,24,118,118,118,24,24,250,101,31,31,0,24,7,7,7,7,7,0,2,2,2,0,0,0,2024-01-08 04:18:00,0
4410,4409,4409,4409,1735,24,144,24,144,1735,0,24,118,118,118,24,24,144,0,27,27,4,24,3,3,3,3,3,0,2,2,2,0,0,0,2024-01-08 04:20:00,0
4407,4406,4406,4406,1732,24,246,24,145,1732,101,24,118,118,118,24,24,246,101,28,28,0,24,4,4,4,4,3,0,2,2,2,0,0,1,2024-01-08 04:22:00,0
4413,4414,4414,4414,1736,24,145,24,145,1736,0,24,118,118,118,24,24,145,0,28,28,0,24,4,4,4,4,4,0,2,2,2,0,0,0,2024-01-08 04:24:00,0
4413,4414,4414,4414,1737,24,148,24,148,1737,0,24,118,118,118,24,24,148,0,31,31,0,24,7,7,7,7,7,0,2,2,2,0,0,0,2024-01-08 04:26:00,0
4422,4422,4422,4422,1738,24,145,24,145,1738,0,24,118,118,118,24,24,145,0,28,28,1,24,4,4,4,4,4,0,2,2,2,0,0,0,2024-01-08 04:28:00,0
4422,4422,4422,4422,1739,24,146,24,146,1739,0,24,119,119,119,24,24,146,0,28,28,2,24,4,4,4,4,4,0,2,2,2,0,0,0,2024-01-08 04:30:00,0
4369,4369,4368,4368,1718,23,245,22,144,1718,101,22,117,117,117,22,22,245,101,28,28,0,22,4,4,4,4,3,0,2,2,2,0,0,1,2024-01-08 04:32:00,0
4427,4426,4426,4426,1744,23,148,24,148,1744,0,24,118,118,118,24,24,148,0,31,31,0,24,7,7,7,7,7,0,2,2,2,0,0,0,2024-01-08 04:34:00,0
4406,4408,4408,4408,1734,24,145,24,145,1734,0,24,118,118,118,24,24,145,0,28,28,2,24,4,4,4,4,4,0,2,2,2,0,0,0,2024-01-08 04:36:00,0
4422,4422,4422,4422,1740,24,145,24,145,1740,0,24,119,119,119,24,24,145,0,27,27,0,24,3,3,3,3,3,0,2,2,2,0,0,0,2024-01-08 04:38:00,0
4415,4415,4415,4415,1736,24,149,24,149,1736,0,24,118,118,118,24,24,149,0,32,32,1,24,8,8,8,8,8,0,2,2,2,0,0,0,2024-01-08 04:40:00,0
4396,4396,4396,4396,1726,24,245,24,144,1726,101,24,118,118,118,24,24,245,101,27,27,1,24,3,3,3,3,3,0,2,2,2,0,0,0,2024-01-08 04:42:00,0
4422,4421,4421,4421,1740,24,145,24,145,1740,0,24,118,118,118,24,24,145,0,28,28,0,24,4,4,4,4,3,0,2,2,2,0,0,1,2024-01-08 04:44:00,0
4416,4417,4417,4417,1740,24,146,24,146,1740,0,24,118,118,118,24,24,146,0,28,28,2,24,4,4,4,4,4,0,2,2,2,0,0,0,2024-01-08 04:46:00,0
4412,4410,4410,4410,1732,24,148,24,148,1732,0,24,118,118,118,24,24,148,0,31,31,0,24,7,7,7,7,6,0,2,2,2,0,0,1,2024-01-08 04:48:00,0
4401,4403,4403,4403,1731,24,144,24,144,1731,0,24,118,118,118,24,24,144,0,28,28,0,24,4,4,4,4,4,0,2,2,2,0,0,0,2024-01-08 04:50:00,0
4682,4682,4682,4682,1739,63,177,63,177,1739,0,63,150,150,150,63,63,177,0,28,28,4,63,4,4,4,4,4,0,2,2,2,0,0,0,2024-01-08 04:52:00,0
4868,4868,4868,4868,1739,97,221,97,221,1739,0,97,173,173,173,97,97,221,0,28,28,0,97,4,4,4,4,4,0,2,2,2,0,0,0,2024-01-08 04:54:00,0
4864,4864,4864,4864,1725,94,218,94,218,1725,0,94,195,195,195,94,94,218,0,31,31,4,94,7,7,7,7,7,0,2,2,2,0,0,0,2024-01-08 04:56:00,0
4876,4874,4874,4874,1739,87,212,87,212,1739,0,87,191,191,191,87,86,212,0,28,28,0,87,4,4,4,4,4,0,2,2,2,0,0,0,2024-01-08 04:58:00,0
4882,4884,4884,4884,1742,91,208,91,208,1742,0,91,196,196,196,91,92,208,0,28,28,0,91,4,4,4,4,3,0,2,2,2,0,0,1,2024-01-08 05:00:00,0
4795,4794,4794,4794,1698,97,318,97,217,1698,101,97,185,185,185,97,97,318,101,31,31,4,97,7,7,7,7,7,0,2,2,2,0,0,0,2024-01-08 05:02:00,0
4856,4857,4857,4857,1734,93,210,93,210,1734,0,93,189,189,189,93,93,210,0,27,27,0,93,3,3,3,3,3,0,2,2,2,0,0,0,2024-01-08 05:04:00,0
4911,4911,4911,4911,1738,100,222,100,222,1738,0,100,188,188,188,100,100,222,0,28,28,2,100,4,4,4,4,3,0,2,2,2,0,0,1,2024-01-08 05:06:00,0
4867,4867,4867,4867,1731,91,210,91,210,1731,0,91,193,193,193,91,91,210,0,28,28,2,91,4,4,4,4,4,0,2,2,2,0,0,0,2024-01-08 05:08:00,0
4868,4866,4866,4866,1740,78,216,78,216,1740,0,78,184,184,184,78,78,216,0,31,31,0,78,7,7,7,7,7,0,2,2,2,0,0,0,2024-01-08 05:10:00,0
4866,4868,4868,4868,1737,93,219,93,219,1737,0,93,183,183,183,93,93,219,0,28,28,2,93,4,4,4,4,4,0,2,2,2,0,0,0,2024-01-08 05:12:00,0
4883,4883,4883,4883,1734,89,221,89,221,1734,0,89,185,185,185,89,89,221,0,28,28,0,89,4,4,4,4,4,0,2,2,2,0,0,0,2024-01-08 05:14:00,0
4895,4894,4894,4894,1744,91,217,91,217,1744,0,91,195,195,195,91,91,217,0,28,28,0,91,4,4,4,4,3,0,2,2,2,0,0,1,2024-01-08 05:16:00,0
4925,4926,4926,4926,1735,99,215,99,215,1735,0,99,201,201,201,99,99,215,0,31,31,4,99,7,7,7,7,7,0,2,2,2,0,0,0,2024-01-08 05:18:00,0
4856,4854,4854,4854,1736,88,206,87,206,1736,0,87,184,184,184,87,87,206,0,28,28,0,87,4,4,4,4,4,0,2,2,2,0,0,0,2024-01-08 05:20:00,0
4838,4840,4840,4840,1720,89,216,90,216,1720,0,90,188,188,188,90,90,216,0,27,27,2,90,3,3,3,3,3,0,2,2,2,0,0,0,2024-01-08 05:22:00,0
4876,4875,4875,4875,1725,95,220,95,220,1725,0,95,191,191,191,95,95,220,0,32,32,0,95,8,8,8,8,8,0,2,2,2,0,0,0,2024-01-08 05:24:00,0
4882,4881,4881,4881,1735,91,220,91,220,1735,0,91,187,187,187,91,91,220,0,27,27,0,91,3,3,3,3,3,0,2,2,2,0,0,0,2024-01-08 05:26:00,0
4904,4905,4905,4905,1730,100,215,100,215,1730,0,100,196,196,196,100,100,215,0,28,28,2,100,4,4,4,4,3,0,2,2,2,0,0,1,2024-01-08 05:28:00,0
4866,4866,4866,4866,1734,90,213,90,213,1734,0,90,192,192,192,90,90,213,0,28,28,0,90,4,4,4,4,4,0,2,2,2,0,0,0,2024-01-08 05:30:00,0
4900,4901,4901,4901,1749,86,317,86,216,1749,101,86,190,190,190,86,86,317,101,31,31,2,86,7,7,7,7,6,0,2,2,2,0,0,1,2024-01-08 05:32:00,0
4897,4897,4897,4897,1726,93,205,93,205,1726,0,93,185,185,185,93,93,205,0,28,28,0,93,4,4,4,4,4,0,2,2,2,0,0,0,2024-01-08 05:34:00,0
4900,4898,4898,4898,1740,94,220,94,220,1740,0,94,185,185,185,94,94,220,0,28,28,0,94,4,4,4,4,4,0,2,2,2,0,0,0,2024-01-08 05:36:00,0
4903,4905,4905,4905,1747,94,318,94,217,1747,101,94,183,183,183,94,94,318,101,31,31,2,94,7,7,7,7,7,0,2,2,2,0,0,0,2024-01-08 05:38:00,0
4874,4874,4874,4874,1738,94,218,94,218,1738,0,94,180,180,180,94,94,218,0,28,28,0,94,4,4,4,4,4,0,2,2,2,0,0,0,2024-01-08 05:40:00,0
4863,4863,4863,4863,1735,83,309,83,208,1735,101,83,185,185,185,83,83,309,101,27,27,0,83,3,3,3,3,3,0,2,2,2,0,0,0,2024-01-08 05:42:00,0
4851,4850,4850,4850,1729,93,220,93,220,1729,0,93,188,188,188,93,93,220,0,28,28,2,93,4,4,4,4,3,0,2,2,2,0,0,1,2024-01-08 05:44:00,0
4894,4894,4894,4894,1740,89,230,89,230,1740,0,89,190,190,190,89,89,230,0,31,31,0,89,7,7,7,7,7,0,2,2,2,0,0,0,2024-01-08 05:46:00,0
4912,4913,4913,4913,1739,92,216,92,216,1739,0,92,198,198,198,92,92,216,0,28,28,4,92,4,4,4,4,3,0,2,2,2,0,0,1,2024-01-08 05:48:00,0
4889,4889,4889,4889,1741,91,214,91,214,1741,0,91,179,179,179,91,91,214,0,28,28,0,91,4,4,4,4,4,0,2,2,2,0,0,0,2024-01-08 05:50:00,0
4894,4893,4893,4893,1737,94,315,94,214,1737,101,94,191,191,191,94,94,315,101,28,28,0,94,4,4,4,4,4,0,2,2,2,0,0,0,2024-01-08 05:52:00,0
4879,4879,4879,4879,1744,92,219,92,219,1744,0,92,191,191,191,92,92,219,0,31,31,0,92,7,7,7,7,6,0,2,2,2,0,0,1,2024-01-08 05:54:00,0
4874,4875,4875,4875,1736,96,216,96,216,1736,0,96,189,189,189,96,96,216,0,28,28,0,96,4,4,4,4,4,0,2,2,2,0,0,0,2024-01-08 05:56:00,0
4864,4864,4864,4864,1733,94,215,94,215,1733,0,94,186,186,186,94,94,215,0,28,28,1,94,4,4,4,4,3,0,2,2,2,0,0,1,2024-01-08 05:58:00,0
4918,4918,4918,4918,1745,91,217,91,217,1745,0,91,200,200,200,91,91,217,0,31,31,0,91,7,7,7,7,7,0,2,2,2,0,0,0,2024-01-08 06:00:00,0
4859,4858,4858,4858,1722,97,319,97,218,1722,101,97,181,181,181,97,97,319,101,28,28,0,97,4,4,4,4,4,0,2,2,2,0,0,0,2024-01-08 06:02:00,0
4867,4868,4868,4868,1740,95,205,95,205,1740,0,95,183,183,183,95,95,205,0,27,27,2,95,3,3,3,3,3,0,2,2,2,0,0,0,2024-01-08 06:04:00,0
4871,4870,4870,4870,1741,88,214,88,214,1741,0,88,179,179,179,88,88,214,0,28,28,0,88,4,4,4,4,4,0,2,2,2,0,0,0,2024-01-08 06:06:00,0
4845,4845,4845,4845,1724,100,218,100,218,1724,0,100,198,198,198,100,100,218,0,31,31,0,100,7,7,7,7,7,0,2,2,2,0,0,0,2024-01-08 06:08:00,0
4897,4897,4897,4897,1739,85,219,85,219,1739,0,85,189,189,189,85,85,219,0,28,28,2,85,4,4,4,4,3,0,2,2,2,0,0,1,2024-01-08 06:10:00,0
4894,4894,4894,4894,1740,82,205,82,205,1740,0,82,189,189,189,82,82,205,0,28,28,0,82,4,4,4,4,4,0,2,2,2,0,0,0,2024-01-08 06:12:00,0
4882,4882,4882,4882,1743,95,208,95,208,1743,0,95,190,190,190,95,95,208,0,28,28,0,95,4,4,4,4,3,0,2,2,2,0,0,1,2024-01-08 06:14:00,0
4888,4889,4889,4889,1739,88,222,88,222,1739,0,88,194,194,194,88,88,222,0,31,31,0,88,7,7,7,7,7,0,2,2,2,0,0,0,2024-01-08 06:16:00,0
4859,4857,4857,4857,1743,95,202,94,202,1743,0,94,182,182,182,94,94,202,0,28,28,0,94,4,4,4,4,4,0,2,2,2,0,0,0,2024-01-08 06:18:00,0
4865,4866,4866,4866,1737,80,212,81,212,1737,0,81,181,181,181,81,81,212,0,27,27,5,81,3,3,3,3,3,0,2,2,2,0,0,0,2024-01-08 06:20:00,0
4851,4852,4852,4852,1731,94,327,94,226,1731,101,94,178,178,178,94,94,327,101,32,32,0,94,8,8,8,8,8,0,2,2,2,0,0,0,2024-01-08 06:22:00,0
4855,4855,4855,4855,1741,88,212,88,212,1741,0,88,174,174,174,88,88,212,0,27,27,2,88,3,3,3,3,3,0,2,2,2,0,0,0,2024-01-08 06:24:00,0
4873,4873,4873,4873,1738,103,207,103,207,1738,0,103,183,183,183,103,103,207,0,28,28,0,103,4,4,4,4,3,0,2,2,2,0,0,1,2024-01-08 06:26:00,0
4883,4882,4882,4882,1747,95,311,95,210,1747,101,95,188,188,188,95,95,311,101,28,28,0,95,4,4,4,4,4,0,2,2,2,0,0,0,2024-01-08 06:28:00,0
4881,4880,4880,4880,1739,92,216,92,216,1739,0,92,180,180,180,92,92,216,0,31,31,4,92,7,7,7,7,6,0,2,2,2,0,0,1,2024-01-08 06:30:00,0
4856,4858,4858,4858,1727,94,220,94,220,1727,0,94,177,177,177,94,94,220,0,27,27,0,94,4,4,4,4,4,0,2,2,2,0,0,0,2024-01-08 06:32:00,0
4885,4884,4884,4884,1737,101,213,101,213,1737,0,101,192,192,192,101,101,213,0,28,28,2,101,4,4,4,4,4,0,2,2,2,0,0,0,2024-01-08 06:34:00,0
4868,4868,4868,4868,1737,91,207,91,207,1737,0,91,183,183,183,91,91,207,0,27,27,0,91,3,3,3,3,3,0,2,2,2,0,0,0,2024-01-08 06:36:00,0
4876,4875,4875,4875,1728,85,319,85,218,1728,101,85,185,185,185,85,85,319,101,32,32,0,85,8,8,8,8,8,0,2,2,2,0,0,0,2024-01-08 06:38:00,0
4907,4908,4908,4908,1741,101,216,101,216,1741,0,101,189,189,189,101,101,216,0,27,27,0,101,3,3,3,3,3,0,2,2,2,0,0,0,2024-01-08 06:40:00,0
4862,4863,4863,4863,1728,88,317,88,216,1728,101,88,183,183,183,88,88,317,101,28,28,0,88,4,4,4,4,3,0,2,2,2,0,0,1,2024-01-08 06:42:00,0
4889,4887,4887,4887,1742,91,216,91,216,1742,0,91,192,192,192,91,91,216,0,31,31,1,91,7,7,7,7,7,0,2,2,2,0,0,0,2024-01-08 06:44:00,0
4878,4880,4880,4880,1735,96,215,96,215,1735,0,96,193,193,193,96,96,215,0,28,28,0,96,4,4,4,4,3,0,2,2,2,0,0,1,2024-01-08 06:46:00,0
4888,4886,4886,4886,1742,92,320,92,219,1742,101,92,184,184,184,92,92,320,101,28,28,0,92,4,4,4,4,4,0,2,2,2,0,0,0,2024-01-08 06:48:00,0
4854,4853,4853,4853,1727,96,211,95,211,1727,0,95,187,187,187,95,95,211,0,28,28,2,95,4,4,4,4,4,0,2,2,2,0,0,0,2024-01-08 06:50:00,0
4870,4873,4873,4873,1737,85,219,86,219,1737,0,86,182,182,182,86,86,219,0,31,31,0,86,7,7,7,7,7,0,2,2,2,0,0,0,2024-01-08 06:52:00,0
4892,4892,4892,4892,1744,89,212,89,212,1744,0,89,189,189,189,89,89,212,0,28,28,0,89,4,4,4,4,3,0,2,2,2,0,0,1,2024-01-08 06:54:00,0
4871,4871,4871,4871,1733,100,214,100,214,1733,0,100,188,188,188,100,100,214,0,28,28,0,100,4,4,4,4,4,0,2,2,2,0,0,0,2024-01-08 06:56:00,0
4905,4905,4905,4905,1742,102,231,102,231,1742,0,102,192,192,192,102,102,231,0,31,31,0,102,7,7,7,7,6,0,2,2,2,0,0,1,2024-01-08 06:58:00,0
4886,4886,4886,4886,1743,79,212,79,212,1743,0,79,189,189,189,79,79,212,0,28,28,2,79,4,4,4,4,4,0,2,2,2,0,0,0,2024-01-08 07:00:00,0
4845,4845,4845,4845,1721,89,309,89,208,1721,101,89,185,185,185,89,89,309,101,28,28,0,89,4,4,4,4,4,0,2,2,2,0,0,0,2024-01-08 07:02:00,0
4868,4868,4868,4868,1744,87,215,87,215,1744,0,87,191,191,191,87,87,215,0,27,27,0,87,3,3,3,3,3,0,2,2,2,0,0,0,2024-01-08 07:04:00,0
4902,4902,4902,4902,1750,96,216,96,216,1750,0,96,188,188,188,96,96,216,0,32,32,2,96,8,8,8,8,8,0,2,2,2,0,0,0,2024-01-08 07:06:00,0
4921,4921,4921,4921,1749,99,312,99,211,1749,101,99,186,186,186,99,99,312,101,27,27,0,99,3,3,3,3,3,0,2,2,2,0,0,0,2024-01-08 07:08:00,0
4900,4900,4900,4900,1750,92,217,92,217,1750,0,92,192,192,192,92,92,217,0,28,28,0,92,4,4,4,4,3,0,2,2,2,0,0,1,2024-01-08 07:10:00,0
4886,4885,4885,4885,1737,91,209,91,209,1737,0,91,185,185,185,91,91,209,0,28,28,0,91,4,4,4,4,4,0,2,2,2,0,0,0,2024-01-08 07:12:00,0
4898,4899,4899,4899,1743,97,221,97,221,1743,0,97,186,186,186,97,97,221,0,31,31,1,97,7,7,7,7,6,0,2,2,2,0,0,1,2024-01-08 07:14:00,0
4880,4879,4879,4879,1734,92,224,92,224,1734,0,92,196,196,196,92,92,224,0,28,28,4,92,4,4,4,4,4,0,2,2,2,0,0,0,2024-01-08 07:16:00,0
4879,4880,4880,4880,1739,96,210,96,210,1739,0,96,195,195,195,96,96,210,0,28,28,0,96,4,4,4,4,4,0,2,2,2,0,0,0,2024-01-08 07:18:00,0
4895,4894,4894,4894,1745,84,220,84,220,1745,0,84,184,184,184,84,84,220,0,31,31,2,84,7,7,7,7,7,0,2,2,2,0,0,0,2024-01-08 07:20:00,0
4810,4811,4811,4811,1715,104,215,104,215,1715,0,104,186,186,186,104,104,215,0,28,28,0,104,4,4,4,4,4,0,2,2,2,0,0,0,2024-01-08 07:22:00,0
4913,4912,4912,4912,1750,86,223,86,223,1750,0,86,186,186,186,86,86,223,0,27,27,0,86,3,3,3,3,3,0,2,2,2,0,0,0,2024-01-08 07:24:00,0
4849,4848,4848,4848,1731,91,205,91,205,1731,0,91,177,177,177,91,91,205,0,28,28,0,91,4,4,4,4,3,0,2,2,2,0,0,1,2024-01-08 07:26:00,0
4863,4864,4864,4864,1739,97,207,97,207,1739,0,97,180,180,180,97,97,207,0,31,31,0,97,7,7,7,7,7,0,2,2,2,0,0,0,2024-01-08 07:28:00,0
4874,4875,4875,4875,1741,92,219,92,219,1741,0,92,186,186,186,92,92,219,0,28,28,1,92,4,4,4,4,3,0,2,2,2,0,0,1,2024-01-08 07:30:00,0
4877,4877,4877,4877,1739,87,217,87,217,1739,0,87,187,187,187,87,87,217,0,28,28,0,87,4,4,4,4,4,0,2,2,2,0,0,0,2024-01-08 07:32:00,0
4918,4918,4918,4918,1746,91,213,91,213,1746,0,91,196,196,196,91,91,213,0,28,28,0,91,4,4,4,4,4,0,2,2,2,0,0,0,2024-01-08 07:34:00,0
4890,4890,4890,4890,1746,86,217,86,217,1746,0,86,186,186,186,86,86,217,0,31,31,4,86,7,7,7,7,7,0,2,2,2,0,0,0,2024-01-08 07:36:00,0
4901,4901,4901,4901,1743,92,216,92,216,1743,0,92,199,199,199,92,92,216,0,28,28,0,92,4,4,4,4,4,0,2,2,2,0,0,0,2024-01-08 07:38:00,0
4881,4881,4880,4880,1734,94,216,94,216,1734,0,94,187,187,187,94,94,216,0,28,28,0,94,4,4,4,4,3,0,2,2,2,0,0,1,2024-01-08 07:40:00,0
4874,4874,4874,4874,1733,98,214,98,214,1733,0,98,184,184,184,98,98,214,0,31,31,4,98,7,7,7,7,7,0,2,2,2,0,0,0,2024-01-08 07:42:00,0
4876,4877,4877,4877,1737,80,211,80,211,1737,0,80,190,190,190,80,80,211,0,27,27,0,80,3,3,3,3,3,0,2,2,2,0,0,0,2024-01-08 07:44:00,0
4859,4858,4858,4858,1728,87,218,87,218,1728,0,87,181,181,181,87,87,218,0,28,28,4,87,4,4,4,4,3,0,2,2,2,0,0,1,2024-01-08 07:46:00,0
4893,4894,4894,4894,1741,104,218,104,218,1741,0,104,181,181,181,104,104,218,0,28,28,0,104,4,4,4,4,4,0,2,2,2,0,0,0,2024-01-08 07:48:00,0
4897,4897,4897,4897,1745,85,217,85,217,1745,0,85,188,188,188,85,85,217,0,31,31,0,85,7,7,7,7,7,0,2,2,2,0,0,0,2024-01-08 07:50:00,0
4896,4893,4893,4893,1745,80,268,80,217,1745,51,80,193,193,193,80,80,268,0,29,29,0,80,5,5,4,4,4,0,2,2,2,0,0,0,2024-01-08 07:52:00,52
4872,4872,4872,4872,1735,84,215,84,215,1735,0,84,180,180,180,84,84,215,0,28,28,1,84,4,4,4,4,4,0,2,2,2,0,0,0,2024-01-08 07:54:00,0
4865,4866,4866,4866,1734,93,220,93,220,1734,0,93,182,182,182,93,93,220,0,31,31,4,93,7,7,7,7,7,0,2,2,2,0,0,0,2024-01-08 07:56:00,0
4903,4905,4905,4905,1747,90,206,90,206,1747,0,90,184,184,184,90,90,206,0,28,28,2,90,4,4,4,4,4,0,2,2,2,0,0,0,2024-01-08 07:58:00,0
4886,4885,4885,4885,1742,81,211,81,211,1742,0,81,183,183,183,81,81,211,0,27,27,0,81,3,3,3,3,3,0,2,2,2,0,0,0,2024-01-08 08:00:00,0
4870,4869,4869,4869,1723,95,522,95,219,1723,303,95,188,188,188,95,95,522,303,28,28,4,95,4,4,4,4,3,0,2,2,2,0,0,1,2024-01-08 08:02:00,0
4897,4896,4896,4896,1744,99,217,99,217,1744,0,99,204,204,204,99,99,217,0,31,31,0,99,7,7,7,7,7,0,2,2,2,0,0,0,2024-01-08 08:04:00,0
4890,4891,4891,4891,1735,93,217,93,217,1735,0,93,182,182,182,93,93,217,0,28,28,0,93,4,4,4,4,3,0,2,2,2,0,0,1,2024-01-08 08:06:00,0
4920,4921,4921,4921,1746,98,213,98,213,1746,0,98,194,194,194,98,98,213,0,28,28,0,98,4,4,4,4,4,0,2,2,2,0,0,0,2024-01-08 08:08:00,0
4855,4856,4856,4856,1723,92,218,92,218,1723,0,92,191,191,191,92,92,218,0,28,28,1,92,4,4,4,4,4,0,2,2,2,0,0,0,2024-01-08 08:10:00,0
4901,4900,4900,4900,1751,95,218,95,218,1751,0,95,188,188,188,95,95,218,0,31,31,0,95,7,7,7,7,7,0,2,2,2,0,0,0,2024-01-08 08:12:00,0
4895,4896,4896,4896,1737,95,218,95,218,1737,0,95,186,186,186,95,95,218,0,28,28,0,95,4,4,4,4,4,0,2,2,2,0,0,0,2024-01-08 08:14:00,0
4884,4883,4883,4883,1746,100,214,100,214,1746,0,100,183,183,183,100,100,214,0,28,28,0,100,4,4,4,4,3,0,2,2,2,0,0,1,2024-01-08 08:16:00,0
4897,4898,4898,4898,1738,88,214,88,214,1738,0,88,201,201,201,88,88,214,0,31,31,4,88,7,7,7,7,7,0,2,2,2,0,0,0,2024-01-08 08:18:00,0
4858,4857,4857,4857,1735,94,210,94,210,1735,0,94,178,178,178,94,94,210,0,27,27,0,94,3,3,3,3,3,0,2,2,2,0,0,0,2024-01-08 08:20:00,0
4837,4837,4837,4837,1724,94,203,94,203,1724,0,94,193,193,193,94,94,203,0,28,28,0,94,4,4,4,4,3,0,2,2,2,0,0,1,2024-01-08 08:22:00,0
4886,4887,4886,4886,1751,84,209,84,209,1751,0,84,180,180,180,84,84,209,0,28,28,0,84,4,4,4,4,4,0,2,2,2,0,0,0,2024-01-08 08:24:00,0
4904,4905,4905,4905,1738,96,220,96,220,1738,0,96,193,193,193,96,96,220,0,31,31,1,96,7,7,7,7,7,0,2,2,2,0,0,0,2024-01-08 08:26:00,0
4891,4890,4890,4890,1748,88,322,88,221,1748,101,88,179,179,179,88,88,322,101,28,28,0,88,4,4,4,4,4,0,2,2,2,0,0,0,2024-01-08 08:28:00,0
4857,4858,4858,4858,1734,93,216,93,216,1734,0,93,182,182,182,93,93,216,0,28,28,0,93,4,4,4,4,4,0,2,2,2,0,0,0,2024-01-08 08:30:00,0
4852,4852,4852,4852,1743,83,198,83,198,1743,0,83,177,177,177,83,83,198,0,28,28,2,83,4,4,4,4,3,0,2,2,2,0,0,1,2024-01-08 08:32:00,0
4854,4853,4853,4853,1722,88,219,88,219,1722,0,88,181,181,181,88,88,219,0,31,31,0,88,7,7,7,7,7,0,2,2,2,0,0,0,2024-01-08 08:34:00,0
4863,4863,4863,4863,1737,86,212,86,212,1737,0,86,175,175,175,86,86,212,0,27,27,0,86,3,3,3,3,3,0,2,2,2,0,0,0,2024-01-08 08:36:00,0
4874,4875,4875,4875,1743,89,218,89,218,1743,0,89,176,176,176,89,89,218,0,28,28,2,89,4,4,4,4,3,0,2,2,2,0,0,1,2024-01-08 08:38:00,0
4917,4917,4917,4917,1739,101,219,101,219,1739,0,101,187,187,187,101,101,219,0,32,32,0,101,8,8,8,8,8,0,2,2,2,0,0,0,2024-01-08 08:40:00,0
4818,4817,4817,4817,1724,93,208,93,208,1724,0,93,185,185,185,93,93,208,0,27,27,0,93,3,3,3,3,3,0,2,2,2,0,0,0,2024-01-08 08:42:00,0
4897,4898,4898,4898,1746,95,211,95,211,1746,0,95,189,189,189,95,95,211,0,28,28,0,95,4,4,4,4,4,0,2,2,2,0,0,0,2024-01-08 08:44:00,0
4880,4880,4880,4880,1748,92,217,92,217,1748,0,92,179,179,179,92,92,217,0,28,28,0,92,4,4,4,4,4,0,2,2,2,0,0,0,2024-01-08 08:46:00,0
4916,4916,4916,4916,1745,91,216,91,216,1745,0,91,194,194,194,91,91,216,0,31,31,1,91,7,7,7,7,6,0,2,2,2,0,0,1,2024-01-08 08:48:00,0
4855,4855,4855,4855,1732,94,210,94,210,1732,0,94,194,194,194,94,94,210,0,28,28,0,94,4,4,4,4,4,0,2,2,2,0,0,0,2024-01-08 08:50:00,0
4857,4855,4855,4855,1732,89,329,89,228,1732,101,89,190,190,190,89,89,329,101,28,28,0,89,4,4,4,4,4,0,2,2,2,0,0,0,2024-01-08 08:52:00,0
4888,4889,4889,4889,1745,99,215,99,215,1745,0,99,181,181,181,99,99,215,0,31,31,2,99,7,7,7,7,7,0,2,2,2,0,0,0,2024-01-08 08:54:00,0
4829,4830,4830,4830,1720,91,208,91,208,1720,0,91,190,190,190,91,91,208,0,28,28,0,91,4,4,4,4,4,0,2,2,2,0,0,0,2024-01-08 08:56:00,0
4893,4892,4892,4892,1746,87,217,87,217,1746,0,87,188,188,188,87,87,217,0,28,28,2,87,4,4,4,4,4,0,2,2,2,0,0,0,2024-01-08 08:58:00,0
4887,4887,4887,4887,1732,100,222,100,222,1732,0,99,185,185,185,99,99,222,0,28,28,0,100,4,4,4,4,3,0,2,2,2,0,0,1,2024-01-08 09:00:00,0
4870,4871,4871,4871,1736,96,417,96,215,1736,202,97,178,178,178,97,97,417,202,31,31,0,96,7,7,7,7,7,0,2,2,2,0,0,0,2024-01-08 09:02:00,0
4890,4888,4888,4888,1738,93,319,93,218,1738,101,93,189,189,189,93,93,319,101,27,27,0,93,3,3,3,3,3,0,2,2,2,0,0,0,2024-01-08 09:04:00,0
4885,4885,4885,4885,1737,91,211,91,211,1737,0,91,186,186,186,91,91,211,0,28,28,0,91,4,4,4,4,3,0,2,2,2,0,0,1,2024-01-08 09:06:00,0
4887,4889,4889,4889,1738,81,226,81,226,1738,0,81,192,192,192,81,81,226,0,28,28,5,81,4,4,4,4,4,0,2,2,2,0,0,0,2024-01-08 09:08:00,0
4929,4927,4927,4927,1747,89,227,89,227,1747,0,89,190,190,190,89,89,227,0,31,31,0,89,7,7,7,7,7,0,2,2,2,0,0,0,2024-01-08 09:10:00,0
4872,4874,4874,4874,1737,87,207,87,207,1737,0,87,192,192,192,87,87,207,0,28,28,0,87,4,4,4,4,4,0,2,2,2,0,0,0,2024-01-08 09:12:00,0
4899,4898,4898,4898,1742,92,225,92,225,1742,0,92,190,190,190,92,92,225,0,28,28,0,92,4,4,4,4,4,0,2,2,2,0,0,0,2024-01-08 09:14:00,0
4913,4914,4914,4914,1740,94,217,94,217,1740,0,94,194,194,194,94,94,217,0,31,31,0,94,7,7,7,7,6,0,2,2,2,0,0,1,2024-01-08 09:16:00,0
4905,4905,4905,4905,1742,92,219,92,219,1742,0,92,194,194,194,92,92,219,0,28,28,5,92,4,4,4,4,4,0,2,2,2,0,0,0,2024-01-08 09:18:00,0
4836,4836,4836,4836,1724,91,216,91,216,1724,0,91,179,179,179,91,91,216,0,26,26,0,91,3,3,3,3,3,0,2,2,2,0,0,0,2024-01-08 09:20:00,0
4861,4861,4860,4860,1738,79,308,79,207,1738,101,79,188,188,188,79,79,308,101,28,28,0,79,4,4,4,4,3,0,2,2,2,0,0,1,2024-01-08 09:22:00,0
4891,4892,4892,4892,1737,98,215,98,215,1737,0,98,187,187,187,98,98,215,0,32,32,0,98,8,8,8,8,8,0,2,2,2,0,0,0,2024-01-08 09:24:00,0
4890,4890,4890,4890,1740,92,211,92,211,1740,0,92,183,183,183,92,92,211,0,27,27,0,92,3,3,3,3,3,0,2,2,2,0,0,0,2024-01-08 09:26:00,0
4883,4883,4883,4883,1737,90,219,90,219,1737,0,90,193,193,193,90,90,219,0,28,28,1,90,4,4,4,4,4,0,2,2,2,0,0,0,2024-01-08 09:28:00,0
4864,4864,4864,4864,1730,83,218,83,218,1730,0,83,183,183,183,83,83,218,0,28,28,0,83,4,4,4,4,4,0,2,2,2,0,0,0,2024-01-08 09:30:00,0
4887,4886,4886,4886,1735,84,325,84,224,1735,101,84,196,196,196,84,84,325,101,31,31,0,84,7,7,7,7,6,0,2,2,2,0,0,1,2024-01-08 09:32:00,0
4882,4881,4881,4881,1740,89,208,89,208,1740,0,89,193,193,193,89,89,208,0,28,28,0,89,4,4,4,4,4,0,2,2,2,0,0,0,2024-01-08 09:34:00,0
4904,4906,4906,4906,1743,85,215,85,215,1743,0,85,188,188,188,85,85,215,0,28,28,0,85,4,4,4,4,3,0,2,2,2,0,0,1,2024-01-08 09:36:00,0
4865,4865,4865,4865,1735,79,309,79,208,1735,101,79,187,187,187,79,79,309,101,31,31,0,79,7,7,7,7,7,0,2,2,2,0,0,0,2024-01-08 09:38:00,0
4853,4853,4853,4853,1733,97,213,97,213,1733,0,97,180,180,180,97,97,213,0,28,28,4,97,4,4,4,4,4,0,2,2,2,0,0,0,2024-01-08 09:40:00,0
4877,4877,4877,4877,1725,85,223,85,223,1725,0,85,189,189,189,85,85,223,0,27,27,0,85,3,3,3,3,3,0,2,2,2,0,0,0,2024-01-08 09:42:00,0
4830,4830,4830,4830,1718,96,216,96,216,1718,0,96,171,171,171,96,96,216,0,28,28,4,96,4,4,4,4,4,0,2,2,2,0,0,0,2024-01-08 09:44:00,0
4872,4872,4872,4872,1736,87,224,87,224,1736,0,87,182,182,182,87,87,224,0,31,31,0,87,7,7,7,7,7,0,2,2,2,0,0,0,2024-01-08 09:46:00,0
4851,4851,4851,4851,1739,87,205,87,205,1739,0,87,179,179,179,87,87,205,0,28,28,0,87,4,4,4,4,3,0,2,2,2,0,0,1,2024-01-08 09:48:00,0
4853,4853,4853,4853,1743,86,204,86,204,1743,0,86,192,192,192,86,86,204,0,28,28,4,86,4,4,4,4,4,0,2,2,2,0,0,0,2024-01-08 09:50:00,0
4884,4884,4884,4884,1739,90,317,90,216,1739,101,90,190,190,190,90,90,317,101,28,28,0,90,4,4,4,4,4,0,2,2,2,0,0,0,2024-01-08 09:52:00,0
4876,4876,4876,4876,1736,89,211,89,211,1736,0,89,197,197,197,89,89,211,0,31,31,2,89,7,7,7,7,6,0,2,2,2,0,0,1,2024-01-08 09:54:00,0
4885,4883,4883,4883,1733,88,213,87,213,1733,0,87,191,191,191,87,87,213,0,28,28,0,87,4,4,4,4,4,0,2,2,2,0,0,0,2024-01-08 09:56:00,0
4885,4886,4886,4886,1735,88,215,89,215,1735,0,89,191,191,191,89,89,215,0,28,28,0,89,4,4,4,4,3,0,2,2,2,0,0,1,2024-01-08 09:58:00,0
4912,4913,4913,4913,1739,101,216,101,216,1739,0,101,183,183,183,101,101,216,0,31,31,2,101,7,7,7,7,7,0,2,2,2,0,0,0,2024-01-08 10:00:00,0
4856,4855,4855,4855,1727,89,322,89,221,1727,101,89,182,182,182,89,89,322,101,28,28,0,89,4,4,4,4,4,0,2,2,2,0,0,0,2024-01-08 10:02:00,0
4897,4898,4898,4898,1744,110,209,110,209,1744,0,110,184,184,184,110,110,209,0,27,27,1,110,3,3,3,3,3,0,2,2,2,0,0,0,2024-01-08 10:04:00,0
4858,4858,4858,4858,1724,99,214,99,214,1724,0,99,177,177,177,99,99,214,0,28,28,1,99,4,4,4,4,4,0,2,2,2,0,0,0,2024-01-08 10:06:00,0
4871,4871,4871,4871,1732,89,211,89,211,1732,0,89,194,194,194,89,89,211,0,31,31,0,89,7,7,7,7,7,0,2,2,2,0,0,0,2024-01-08 10:08:00,0
4866,4866,4866,4866,1740,88,198,88,198,1740,0,88,191,191,191,88,88,198,0,28,28,4,88,4,4,4,4,3,0,2,2,2,0,0,1,2024-01-08 10:10:00,0
4901,4901,4901,4901,1742,90,217,90,217,1742,0,90,179,179,179,90,90,217,0,28,28,0,90,4,4,4,4,4,0,2,2,2,0,0,0,2024-01-08 10:12:00,0
4882,4882,4882,4882,1743,94,217,94,217,1743,0,94,183,183,183,94,94,217,0,31,31,0,94,7,7,7,7,6,0,2,2,2,0,0,1,2024-01-08 10:14:00,0
4873,4871,4871,4871,1736,85,216,84,216,1736,0,84,192,192,192,84,84,216,0,28,28,0,84,4,4,4,4,4,0,2,2,2,0,0,0,2024-01-08 10:16:00,0
4896,4898,4898,4898,1746,91,210,92,210,1746,0,92,193,193,193,92,92,210,0,28,28,0,92,4,4,4,4,4,0,2,2,2,0,0,0,2024-01-08 10:18:00,0
4898,4898,4898,4898,1739,96,221,96,221,1739,0,96,180,180,180,96,96,221,0,27,27,3,96,3,3,3,3,3,0,2,2,2,0,0,0,2024-01-08 10:20:00,0
4849,4849,4849,4849,1732,97,210,97,210,1732,0,97,184,184,184,97,97,210,0,32,32,0,97,8,8,8,8,8,0,2,2,2,0,0,0,2024-01-08 10:22:00,0
4884,4883,4883,4883,1747,95,210,95,210,1747,0,95,186,186,186,95,95,210,0,27,27,0,95,3,3,3,3,3,0,2,2,2,0,0,0,2024-01-08 10:24:00,0
4876,4876,4876,4876,1738,93,219,93,219,1738,0,93,181,181,181,93,93,219,0,28,28,2,93,4,4,4,4,3,0,2,2,2,0,0,1,2024-01-08 10:26:00,0
4849,4850,4850,4850,1728,92,205,92,205,1728,0,92,186,186,186,92,92,205,0,28,28,0,92,4,4,4,4,4,0,2,2,2,0,0,0,2024-01-08 10:28:00,0
4894,4893,4893,4893,1742,97,213,97,213,1742,0,97,199,199,199,97,97,213,0,31,31,4,97,7,7,7,7,6,0,2,2,2,0,0,1,2024-01-08 10:30:00,0
4909,4907,4907,4907,1744,100,311,100,210,1744,101,100,193,193,193,100,100,311,101,28,28,0,100,4,4,4,4,4,0,2,2,2,0,0,0,2024-01-08 10:32:00,0
4887,4890,4890,4890,1743,93,209,93,209,1743,0,93,190,190,190,93,93,209,0,28,28,0,93,4,4,4,4,4,0,2,2,2,0,0,0,2024-01-08 10:34:00,0
4906,4905,4905,4905,1738,87,226,87,226,1738,0,87,189,189,189,87,87,226,0,31,31,0,87,7,7,7,7,7,0,2,2,2,0,0,0,2024-01-08 10:36:00,0
4898,4899,4899,4899,1727,102,204,102,204,1727,0,102,194,194,194,102,102,204,0,28,28,0,102,4,4,4,4,4,0,2,2,2,0,0,0,2024-01-08 10:38:00,0
4895,4892,4892,4892,1744,92,212,92,212,1744,0,92,185,185,185,92,92,212,0,27,27,1,92,3,3,3,3,3,0,2,2,2,0,0,0,2024-01-08 10:40:00,0
4863,4865,4865,4865,1735,95,218,95,218,1735,0,95,176,176,176,95,95,218,0,28,28,2,95,4,4,4,4,3,0,2,2,2,0,0,1,2024-01-08 10:42:00,0
4903,4902,4902,4902,1751,95,213,95,213,1751,0,94,194,194,194,94,94,213,0,31,31,0,95,7,7,7,7,7,0,2,2,2,0,0,0,2024-01-08 10:44:00,0
4866,4868,4868,4868,1741,89,213,89,213,1741,0,90,170,170,170,90,90,213,0,28,28,4,89,4,4,4,4,3,0,2,2,2,0,0,1,2024-01-08 10:46:00,0
4882,4879,4879,4879,1738,83,224,83,224,1738,0,83,189,189,189,83,83,224,0,28,28,0,83,4,4,4,4,4,0,2,2,2,0,0,0,2024-01-08 10:48:00,0
4882,4885,4885,4885,1739,97,207,97,207,1739,0,97,181,181,181,97,97,207,0,28,28,0,97,4,4,4,4,4,0,2,2,2,0,0,0,2024-01-08 10:50:00,0
4847,4847,4847,4847,1726,87,363,87,211,1726,152,87,196,196,196,87,87,363,101,32,32,0,87,8,8,7,7,7,0,2,2,2,0,0,0,2024-01-08 10:52:00,52
4877,4877,4877,4877,1736,95,211,95,211,1736,0,95,190,190,190,95,95,211,0,28,28,0,95,4,4,4,4,4,0,2,2,2,0,0,0,2024-01-08 10:54:00,0
4881,4881,4881,4881,1743,94,208,94,207,1743,1,94,182,182,182,94,94,208,1,27,27,5,94,3,3,3,3,3,0,2,2,2,0,0,0,2024-01-08 10:56:00,0
4892,4892,4892,4892,1749,86,312,86,211,1749,101,86,183,183,183,86,86,312,101,32,32,0,86,8,8,8,8,8,0,2,2,2,0,0,0,2024-01-08 10:58:00,0
4914,4913,4913,4913,1746,106,214,106,214,1746,0,106,186,186,186,106,106,214,0,27,27,0,106,3,3,3,3,3,0,2,2,2,0,0,0,2024-01-08 11:00:00,0
4859,4860,4860,4860,1734,95,409,95,207,1734,202,95,186,186,186,95,95,409,202,28,28,4,95,4,4,4,4,3,0,2,2,2,0,0,1,2024-01-08 11:02:00,0
4901,4900,4900,4900,1747,85,313,85,212,1747,101,85,179,179,179,85,85,313,101,28,28,0,85,4,4,4,4,4,0,2,2,2,0,0,0,2024-01-08 11:04:00,0
4853,4853,4853,4853,1737,100,213,100,213,1737,0,100,177,177,177,100,100,213,0,31,31,0,100,7,7,7,7,6,0,2,2,2,0,0,1,2024-01-08 11:06:00,0
4852,4852,4852,4852,1725,94,207,94,207,1725,0,94,185,185,185,94,94,207,0,28,28,4,94,4,4,4,4,4,0,2,2,2,0,0,0,2024-01-08 11:08:00,0
4880,4880,4880,4880,1753,87,203,87,203,1753,0,87,193,193,193,87,87,203,0,28,28,0,87,4,4,4,4,4,0,2,2,2,0,0,0,2024-01-08 11:10:00,0
4897,4919,4898,4898,1741,99,317,99,216,1741,101,99,193,193,193,99,99,317,101,31,31,0,99,7,7,7,7,7,0,2,2,2,0,0,0,2024-01-08 11:12:00,0
4896,4894,4894,4894,1747,81,215,81,215,1747,0,81,186,186,186,81,81,215,0,28,28,0,81,4,4,4,4,4,0,2,2,2,0,0,0,2024-01-08 11:14:00,0
4872,4874,4874,4874,1734,102,204,102,204,1734,0,102,187,187,187,102,102,204,0,27,27,0,102,3,3,3,3,3,0,2,2,2,0,0,0,2024-01-08 11:16:00,0
4883,4882,4882,4882,1737,100,207,100,207,1737,0,100,188,188,188,100,100,207,0,28,28,5,100,4,4,4,4,3,0,2,2,2,0,0,1,2024-01-08 11:18:00,0
4862,4863,4863,4863,1728,96,207,96,207,1728,0,96,183,183,183,96,96,207,0,31,31,0,96,7,7,7,7,7,0,2,2,2,0,0,0,2024-01-08 11:20:00,0
4837,4835,4835,4835,1719,94,309,94,208,1719,101,94,187,187,187,94,94,309,101,28,28,4,94,4,4,4,4,3,0,2,2,2,0,0,1,2024-01-08 11:22:00,0
4879,4881,4881,4881,1741,105,211,105,211,1741,0,105,187,187,187,105,105,211,0,28,28,0,105,4,4,4,4,4,0,2,2,2,0,0,0,2024-01-08 11:24:00,0
4874,4874,4874,4874,1729,88,217,88,217,1729,0,88,195,195,195,88,88,217,0,28,28,0,88,4,4,4,4,4,0,2,2,2,0,0,0,2024-01-08 11:26:00,0
4910,4910,4910,4910,1734,88,314,88,213,1734,101,88,201,201,201,88,88,314,101,31,31,4,88,7,7,7,7,7,0,2,2,2,0,0,0,2024-01-08 11:28:00,0
4906,4906,4906,4906,1740,96,216,96,216,1740,0,96,204,204,204,96,96,216,0,28,28,0,96,4,4,4,4,4,0,2,2,2,0,0,0,2024-01-08 11:30:00,0
4876,4876,4876,4876,1738,86,224,86,224,1738,0,86,185,185,185,86,86,224,0,28,28,3,86,4,4,4,4,3,0,2,2,2,0,0,1,2024-01-08 11:32:00,0
4840,4840,4840,4840,1729,89,214,89,214,1729,0,89,185,185,185,89,89,214,0,31,31,1,89,7,7,7,7,7,0,2,2,2,0,0,0,2024-01-08 11:34:00,0
4909,4909,4909,4909,1741,87,219,87,219,1741,0,87,188,188,188,87,87,219,0,27,27,0,87,3,3,3,3,3,0,2,2,2,0,0,0,2024-01-08 11:36:00,0
4865,4865,4865,4865,1730,99,313,99,212,1730,101,99,188,188,188,99,99,313,101,28,28,4,99,4,4,4,4,3,0,2,2,2,0,0,1,2024-01-08 11:38:00,0
4861,4861,4861,4861,1727,92,212,92,212,1727,0,92,193,193,193,92,92,212,0,28,28,0,92,4,4,4,4,4,0,2,2,2,0,0,0,2024-01-08 11:40:00,0
4869,4867,4867,4867,1731,96,219,96,219,1731,0,96,199,199,199,96,96,219,0,31,31,0,96,7,7,7,7,7,0,2,2,2,0,0,0,2024-01-08 11:42:00,0
4889,4890,4890,4890,1742,100,221,100,221,1742,0,100,186,186,186,100,100,221,0,28,28,4,100,4,4,4,4,4,0,2,2,2,0,0,0,2024-01-08 11:44:00,0
4897,4898,4898,4898,1742,94,204,94,204,1742,0,94,186,186,186,94,94,204,0,28,28,0,94,4,4,4,4,4,0,2,2,2,0,0,0,2024-01-08 11:46:00,0
4927,4926,4926,4926,1741,82,220,82,220,1741,0,82,200,200,200,82,82,220,0,28,28,2,82,4,4,4,4,3,0,2,2,2,0,0,1,2024-01-08 11:48:00,0
4859,4860,4860,4860,1728,86,210,86,210,1728,0,86,187,187,187,86,86,210,0,31,31,0,86,7,7,7,7,7,0,2,2,2,0,0,0,2024-01-08 11:50:00,0
4869,4868,4868,4868,1737,89,212,88,212,1737,0,88,184,184,184,88,88,212,0,28,28,0,88,4,4,4,4,4,0,2,2,2,0,0,0,2024-01-08 11:52:00,0
4872,4872,4872,4872,1738,84,216,85,216,1738,0,85,182,182,182,85,85,216,0,28,28,4,85,4,4,4,4,4,0,2,2,2,0,0,0,2024-01-08 11:54:00,0
4921,4922,4922,4922,1744,102,213,102,213,1744,0,102,203,203,203,102,102,213,0,31,31,0,102,7,7,7,7,7,0,2,2,2,0,0,0,2024-01-08 11:56:00,0
4897,4897,4897,4897,1743,93,226,93,226,1743,0,93,175,175,175,93,93,226,0,28,28,4,93,4,4,4,4,4,0,2,2,2,0,0,0,2024-01-08 11:58:00,0
4889,4889,4889,4889,1742,86,211,86,211,1742,0,86,184,184,184,86,86,211,0,27,27,0,86,3,3,3,3,3,0,2,2,2,0,0,0,2024-01-08 12:00:00,0
4808,4808,4808,4808,1717,88,210,88,210,1717,0,88,185,185,185,88,88,210,0,27,27,0,88,4,4,4,4,3,0,2,2,2,0,0,1,2024-01-08 12:02:00,0
4893,4892,4892,4892,1736,91,524,91,221,1736,303,91,184,184,184,91,91,524,303,31,31,0,91,7,7,7,7,7,0,2,2,2,0,0,0,2024-01-08 12:04:00,0
4907,4908,4908,4908,1747,99,311,99,210,1747,101,99,186,186,186,99,99,311,101,28,28,0,99,4,4,4,4,3,0,2,2,2,0,0,1,2024-01-08 12:06:00,0
4865,4864,4864,4864,1734,95,414,95,212,1734,202,95,179,179,179,95,95,414,202,28,28,1,95,4,4,4,4,4,0,2,2,2,0,0,0,2024-01-08 12:08:00,0
4872,4873,4873,4873,1735,82,218,82,218,1735,0,82,184,184,184,82,82,218,0,31,31,0,82,7,7,7,7,7,0,2,2,2,0,0,0,2024-01-08 12:10:00,0
4904,4904,4904,4904,1739,93,214,93,214,1739,0,93,192,192,192,93,93,214,0,28,28,0,93,4,4,4,4,4,0,2,2,2,0,0,0,2024-01-08 12:12:00,0
4897,4897,4897,4897,1740,95,220,95,220,1740,0,95,194,194,194,95,95,220,0,28,28,4,95,4,4,4,4,4,0,2,2,2,0,0,0,2024-01-08 12:14:00,0
4901,4901,4901,4901,1742,97,223,97,223,1742,0,97,199,199,199,97,97,223,0,28,28,0,97,4,4,4,4,3,0,2,2,2,0,0,1,2024-01-08 12:16:00,0
4884,4884,4884,4884,1734,95,324,95,223,1734,101,95,183,183,183,95,95,324,101,32,32,0,95,7,7,7,7,7,0,2,2,2,0,0,0,2024-01-08 12:18:00,0
4869,4869,4869,4869,1736,100,203,100,203,1736,0,100,183,183,183,100,100,203,0,27,27,2,100,3,3,3,3,3,0,2,2,2,0,0,0,2024-01-08 12:20:00,0
4885,4885,4885,4885,1735,103,323,103,222,1735,101,103,184,184,184,103,103,323,101,28,28,0,103,4,4,4,4,3,0,2,2,2,0,0,1,2024-01-08 12:22:00,0
4856,4855,4855,4855,1727,92,216,92,216,1727,0,92,186,186,186,92,92,216,0,27,27,2,92,4,4,4,4,4,0,2,2,2,0,0,0,2024-01-08 12:24:00,0
4872,4872,4872,4872,1736,87,210,87,210,1736,0,87,186,186,186,87,87,210,0,31,31,0,87,7,7,7,7,7,0,2,2,2,0,0,0,2024-01-08 12:26:00,0
4910,4909,4909,4909,1745,85,219,85,219,1745,0,85,182,182,182,85,85,219,0,28,28,0,85,4,4,4,4,4,0,2,2,2,0,0,0,2024-01-08 12:28:00,0
4909,4911,4911,4911,1742,87,215,87,215,1742,0,87,186,186,186,87,87,215,0,28,28,2,87,4,4,4,4,4,0,2,2,2,0,0,0,2024-01-08 12:30:00,0
4884,4883,4883,4883,1739,95,216,95,216,1739,0,95,186,186,186,95,95,216,0,31,31,0,95,7,7,7,7,6,0,2,2,2,0,0,1,2024-01-08 12:32:00,0
4919,4920,4920,4920,1743,95,216,95,216,1743,0,95,196,196,196,95,95,216,0,28,28,2,95,4,4,4,4,4,0,2,2,2,0,0,0,2024-01-08 12:34:00,0
4883,4882,4882,4882,1737,95,207,95,207,1737,0,95,190,190,190,95,95,207,0,27,27,2,95,3,3,3,3,3,0,2,2,2,0,0,0,2024-01-08 12:36:00,0
4880,4880,4880,4880,1733,93,211,93,211,1733,0,93,184,184,184,93,93,211,0,28,28,0,93,4,4,4,4,3,0,2,2,2,0,0,1,2024-01-08 12:38:00,0
4871,4871,4871,4871,1737,81,216,81,216,1737,0,81,185,185,185,81,81,216,0,32,32,4,81,8,8,8,8,8,0,2,2,2,0,0,0,2024-01-08 12:40:00,0
4856,4857,4857,4857,1735,95,312,95,211,1735,101,95,182,182,182,95,95,312,101,27,27,0,95,3,3,3,3,3,0,2,2,2,0,0,0,2024-01-08 12:42:00,0
4896,4895,4895,4895,1736,94,218,94,218,1736,0,94,187,187,187,94,94,218,0,28,28,0,94,4,4,4,4,4,0,2,2,2,0,0,0,2024-01-08 12:44:00,0
4825,4826,4826,4826,1718,92,205,92,205,1718,0,92,182,182,182,92,92,205,0,28,28,4,92,4,4,4,4,4,0,2,2,2,0,0,0,2024-01-08 12:46:00,0
4860,4860,4860,4860,1731,85,313,85,212,1731,101,85,183,183,183,85,85,313,101,31,31,0,85,7,7,7,7,6,0,2,2,2,0,0,1,2024-01-08 12:48:00,0
4878,4878,4877,4877,1729,93,209,93,209,1729,0,93,189,189,189,93,93,209,0,28,28,0,93,4,4,4,4,4,0,2,2,2,0,0,0,2024-01-08 12:50:00,0
4871,4872,4872,4872,1741,88,218,88,218,1741,0,88,180,180,180,88,88,218,0,28,28,0,88,4,4,4,4,4,0,2,2,2,0,0,0,2024-01-08 12:52:00,0
4892,4892,4892,4892,1737,86,216,86,216,1737,0,86,192,192,192,86,86,216,0,31,31,1,86,7,7,7,7,7,0,2,2,2,0,0,0,2024-01-08 12:54:00,0
4856,4856,4856,4856,1724,93,205,93,205,1724,0,93,187,187,187,93,93,205,0,28,28,4,93,4,4,4,4,4,0,2,2,2,0,0,0,2024-01-08 12:56:00,0
4902,4902,4902,4902,1740,96,208,96,208,1740,0,96,198,198,198,96,96,208,0,28,28,0,96,4,4,4,4,4,0,2,2,2,0,0,0,2024-01-08 12:58:00,0
4872,4872,4872,4872,1734,100,213,100,213,1734,0,100,187,187,187,100,100,213,0,28,28,4,100,4,4,4,4,3,0,2,2,2,0,0,1,2024-01-08 13:00:00,0
4850,4849,4849,4849,1726,82,215,82,215,1726,0,82,188,188,188,82,82,215,0,31,31,0,82,7,7,7,7,7,0,2,2,2,0,0,0,2024-01-08 13:02:00,0
4878,4878,4878,4878,1743,108,310,108,209,1743,101,108,180,180,180,108,108,310,101,27,27,0,108,3,3,3,3,3,0,2,2,2,0,0,0,2024-01-08 13:04:00,0
4881,4880,4880,4880,1735,98,217,98,217,1735,0,98,198,198,198,98,98,217,0,28,28,4,98,4,4,4,4,3,0,2,2,2,0,0,1,2024-01-08 13:06:00,0
4874,4875,4875,4875,1733,93,315,93,214,1733,101,93,185,185,185,93,93,315,101,32,32,0,93,8,8,8,8,8,0,2,2,2,0,0,0,2024-01-08 13:08:00,0
4824,4824,4824,4824,1727,88,206,88,206,1727,0,88,191,191,191,88,88,206,0,27,27,4,88,3,3,3,3,3,0,2,2,2,0,0,0,2024-01-08 13:10:00,0
4886,4886,4886,4886,1741,88,206,88,206,1741,0,88,193,193,193,88,88,206,0,28,28,0,88,4,4,4,4,4,0,2,2,2,0,0,0,2024-01-08 13:12:00,0
4897,4898,4898,4898,1743,97,221,97,221,1743,0,97,185,185,185,97,97,221,0,28,28,0,97,4,4,4,4,4,0,2,2,2,0,0,0,2024-01-08 13:14:00,0
4911,4911,4911,4911,1742,96,224,96,224,1742,0,96,183,183,183,96,96,224,0,31,31,4,96,7,7,7,7,6,0,2,2,2,0,0,1,2024-01-08 13:16:00,0
4847,4846,4846,4846,1728,91,216,91,216,1728,0,91,188,188,188,91,91,216,0,28,28,0,91,4,4,4,4,4,0,2,2,2,0,0,0,2024-01-08 13:18:00,0
4874,4875,4875,4875,1731,87,220,87,220,1731,0,87,180,180,180,87,87,220,0,28,28,0,87,4,4,4,4,3,0,2,2,2,0,0,1,2024-01-08 13:20:00,0
4904,4904,4904,4904,1734,103,327,103,226,1734,101,103,193,193,193,103,103,327,101,27,27,2,103,3,3,3,3,3,0,2,2,2,0,0,0,2024-01-08 13:22:00,0
4872,4872,4872,4872,1746,90,209,90,209,1746,0,90,176,176,176,90,90,209,0,32,32,0,90,8,8,8,8,8,0,2,2,2,0,0,0,2024-01-08 13:24:00,0
4859,4858,4858,4858,1735,86,206,86,206,1735,0,86,183,183,183,86,86,206,0,27,27,2,86,3,3,3,3,3,0,2,2,2,0,0,0,2024-01-08 13:26:00,0
4875,4876,4876,4876,1731,95,214,95,214,1731,0,95,179,179,179,95,95,214,0,28,28,0,95,4,4,4,4,4,0,2,2,2,0,0,0,2024-01-08 13:28:00,0
4873,4871,4871,4871,1734,98,213,98,213,1734,0,98,197,197,197,98,98,213,0,31,31,0,98,7,7,7,7,7,0,2,2,2,0,0,0,2024-01-08 13:30:00,0
4866,4867,4867,4867,1733,86,218,86,218,1733,0,86,174,174,174,86,86,218,0,28,28,0,86,4,4,4,4,3,0,2,2,2,0,0,1,2024-01-08 13:32:00,0
4851,4852,4852,4852,1731,81,214,81,214,1731,0,81,190,190,190,81,81,214,0,28,28,0,81,4,4,4,4,4,0,2,2,2,0,0,0,2024-01-08 13:34:00,0
4870,4869,4869,4869,1731,97,210,97,210,1731,0,97,189,189,189,97,97,210,0,28,28,5,97,4,4,4,4,3,0,2,2,2,0,0,1,2024-01-08 13:36:00,0
4892,4894,4893,4893,1748,87,213,87,213,1748,0,87,178,178,178,87,87,213,0,31,31,0,87,7,7,7,7,7,0,2,2,2,0,0,0,2024-01-08 13:38:00,0
4895,4894,4894,4894,1736,90,223,90,223,1736,0,90,188,188,188,90,90,223,0,28,28,0,90,4,4,4,4,4,0,2,2,2,0,0,0,2024-01-08 13:40:00,0
4899,4900,4900,4900,1739,93,227,93,227,1739,0,93,188,188,188,93,93,227,0,27,27,2,93,3,3,3,3,3,0,2,2,2,0,0,0,2024-01-08 13:42:00,0
4907,4905,4905,4905,1754,86,212,86,212,1754,0,86,188,188,188,86,86,212,0,28,28,0,86,4,4,4,4,4,0,2,2,2,0,0,0,2024-01-08 13:44:00,0
4871,4873,4873,4873,1733,84,205,84,205,1733,0,84,189,189,189,84,84,205,0,31,31,0,84,7,7,7,7,7,0,2,2,2,0,0,0,2024-01-08 13:46:00,0
4877,4875,4875,4875,1742,87,210,86,210,1742,0,86,180,180,180,86,86,210,0,28,28,2,86,4,4,4,4,3,0,2,2,2,0,0,1,2024-01-08 13:48:00,0
4878,4880,4880,4880,1732,87,212,88,212,1732,0,88,180,180,180,88,88,212,0,28,28,0,88,4,4,4,4,4,0,2,2,2,0,0,0,2024-01-08 13:50:00,0
4894,4893,4893,4893,1735,101,217,101,217,1735,0,101,189,189,189,101,101,217,0,31,31,2,101,7,7,7,7,7,0,2,2,2,0,0,0,2024-01-08 13:52:00,0
4858,4859,4859,4859,1740,93,204,93,204,1740,0,93,180,180,180,93,93,204,0,28,28,0,93,4,4,4,4,3,0,2,2,2,0,0,1,2024-01-08 13:54:00,0
4908,4908,4908,4908,1741,90,221,90,221,1741,0,90,188,188,188,90,90,221,0,28,28,0,90,4,4,4,4,4,0,2,2,2,0,0,0,2024-01-08 13:56:00,0
4846,4846,4846,4846,1722,89,214,89,214,1722,0,89,190,190,190,89,89,214,0,28,28,2,89,4,4,4,4,3,0,2,2,2,0,0,1,2024-01-08 13:58:00,0
4907,4907,4907,4907,1744,89,213,89,213,1744,0,89,198,198,198,89,89,213,0,31,31,0,89,7,7,7,7,7,0,2,2,2,0,0,0,2024-01-08 14:00:00,0
4881,4881,4881,4881,1731,85,519,85,216,1731,303,85,186,186,186,85,85,519,303,28,28,4,85,4,4,4,4,4,0,2,2,2,0,0,0,2024-01-08 14:02:00,0
4906,4906,4906,4906,1735,97,220,97,220,1735,0,97,186,186,186,97,97,220,0,27,27,0,97,3,3,3,3,3,0,2,2,2,0,0,0,2024-01-08 14:04:00,0
4900,4899,4899,4899,1738,98,232,98,232,1738,0,98,180,180,180,98,98,232,0,31,31,0,98,7,7,7,7,7,0,2,2,2,0,0,0,2024-01-08 14:06:00,0
4906,4906,4906,4906,1748,96,220,96,220,1748,0,96,193,193,193,96,96,220,0,28,28,4,96,4,4,4,4,4,0,2,2,2,0,0,0,2024-01-08 14:08:00,0
4880,4881,4881,4881,1736,84,219,84,219,1736,0,84,186,186,186,84,84,219,0,28,28,0,84,4,4,4,4,3,0,2,2,2,0,0,1,2024-01-08 14:10:00,0
4851,4851,4851,4851,1741,88,207,88,207,1741,0,88,189,189,189,88,88,207,0,28,28,4,88,4,4,4,4,4,0,2,2,2,0,0,0,2024-01-08 14:12:00,0
4888,4888,4887,4887,1747,80,215,80,215,1747,0,80,190,190,190,80,80,215,0,31,31,0,80,7,7,7,7,6,0,2,2,2,0,0,1,2024-01-08 14:14:00,0
4904,4905,4905,4905,1740,102,210,102,210,1740,0,102,178,178,178,102,102,210,0,28,28,0,102,4,4,4,4,4,0,2,2,2,0,0,0,2024-01-08 14:16:00,0
4872,4871,4871,4871,1745,91,209,91,209,1745,0,91,189,189,189,91,91,209,0,28,28,4,91,4,4,4,4,4,0,2,2,2,0,0,0,2024-01-08 14:18:00,0
4797,4798,4798,4798,1721,87,208,87,208,1721,0,87,185,185,185,87,87,208,0,27,27,0,87,3,3,3,3,3,0,2,2,2,0,0,0,2024-01-08 14:20:00,0
4866,4865,4865,4865,1731,89,320,89,219,1731,101,89,188,188,188,89,89,320,101,32,32,0,89,8,8,8,8,8,0,2,2,2,0,0,0,2024-01-08 14:22:00,0
4860,4861,4861,4861,1734,91,214,91,214,1734,0,91,182,182,182,91,91,214,0,27,27,4,91,3,3,3,3,3,0,2,2,2,0,0,0,2024-01-08 14:24:00,0
4875,4875,4875,4875,1740,91,214,91,214,1740,0,91,178,178,178,91,91,214,0,28,28,0,91,4,4,4,4,3,0,2,2,2,0,0,1,2024-01-08 14:26:00,0
4859,4857,4857,4857,1734,80,224,80,224,1734,0,80,187,187,187,80,80,224,0,31,31,4,80,7,7,7,7,7,0,2,2,2,0,0,0,2024-01-08 14:28:00,0
4873,4874,4874,4874,1737,95,211,95,211,1737,0,95,180,180,180,95,95,211,0,28,28,0,95,4,4,4,4,3,0,2,2,2,0,0,1,2024-01-08 14:30:00,0
4899,4900,4900,4900,1741,90,210,90,210,1741,0,90,180,180,180,90,90,210,0,28,28,0,90,4,4,4,4,4,0,2,2,2,0,0,0,2024-01-08 14:32:00,0
4913,4913,4913,4913,1744,104,223,104,223,1744,0,104,178,178,178,104,104,223,0,28,28,4,104,4,4,4,4,4,0,2,2,2,0,0,0,2024-01-08 14:34:00,0
4900,4900,4900,4900,1748,84,228,84,228,1748,0,84,185,185,185,84,84,228,0,31,31,0,84,7,7,7,7,7,0,2,2,2,0,0,0,2024-01-08 14:36:00,0
4907,4908,4907,4907,1742,98,318,98,217,1742,101,98,191,191,191,98,98,318,101,28,28,4,98,4,4,4,4,4,0,2,2,2,0,0,0,2024-01-08 14:38:00,0
4894,4893,4893,4893,1738,90,215,90,215,1738,0,90,186,186,186,90,90,215,0,28,28,0,90,4,4,4,4,3,0,2,2,2,0,0,1,2024-01-08 14:40:00,0
4893,4893,4893,4893,1737,103,324,103,223,1737,101,103,189,189,189,103,103,324,101,27,27,0,103,3,3,3,3,3,0,2,2,2,0,0,0,2024-01-08 14:42:00,0
4861,4861,4861,4861,1726,94,219,94,219,1726,0,94,182,182,182,94,94,219,0,30,30,0,94,7,7,7,7,7,0,2,2,2,0,0,0,2024-01-08 14:44:00,0
4891,4892,4892,4892,1739,91,214,91,214,1739,0,91,189,189,189,91,91,214,0,28,28,0,91,4,4,4,4,3,0,2,2,2,0,0,1,2024-01-08 14:46:00,0
4873,4872,4872,4872,1729,102,202,102,202,1729,0,102,187,187,187,102,102,202,0,28,28,5,102,4,4,4,4,4,0,2,2,2,0,0,0,2024-01-08 14:48:00,0
4885,4885,4885,4885,1733,91,224,91,224,1733,0,91,194,194,194,91,91,224,0,31,31,0,91,7,7,7,7,7,0,2,2,2,0,0,0,2024-01-08 14:50:00,0
4839,4839,4839,4839,1846,49,219,49,168,1846,51,49,133,133,133,49,49,219,0,29,29,0,49,5,5,4,4,4,0,2,2,2,0,0,0,2024-01-08 14:52:00,52
5142,5143,5143,5143,2039,24,146,24,146,2039,0,24,118,118,118,24,24,146,0,28,28,4,24,4,4,4,4,4,0,2,2,2,0,0,0,2024-01-08 14:54:00,0
5145,5145,5145,5145,2038,24,145,24,145,2038,0,24,119,119,119,24,24,145,0,27,27,0,24,3,3,3,3,3,0,2,2,2,0,0,0,2024-01-08 14:56:00,0
5102,5102,5102,5102,2016,24,150,24,150,2016,0,24,118,118,118,24,24,150,0,33,33,0,24,8,8,8,8,8,0,2,2,2,0,0,0,2024-01-08 14:58:00,0
5147,5147,5147,5147,2038,24,145,24,145,2038,0,24,119,119,119,24,24,145,0,27,27,0,24,3,3,3,3,3,0,2,2,2,0,0,0,2024-01-08 15:00:00,0
5110,5109,5109,5109,2019,24,347,24,145,2019,202,24,118,118,118,24,24,347,202,28,28,0,24,4,4,4,4,3,0,2,2,2,0,0,1,2024-01-08 15:02:00,0
5123,5124,5124,5124,2026,24,246,24,145,2026,101,24,119,119,119,24,24,246,101,28,28,5,24,4,4,4,4,4,0,2,2,2,0,0,0,2024-01-08 15:04:00,0
5093,5093,5093,5093,2015,24,147,24,147,2015,0,24,117,117,117,24,24,147,0,30,30,0,24,7,7,7,7,6,0,2,2,2,0,0,1,2024-01-08 15:06:00,0
5114,5113,5113,5113,2024,22,145,22,145,2024,0,22,119,119,119,22,22,145,0,28,28,0,22,4,4,4,4,4,0,2,2,2,0,0,0,2024-01-08 15:08:00,0
5113,5112,5112,5112,2022,24,145,24,145,2022,0,24,118,118,118,24,24,145,0,28,28,0,24,4,4,4,4,4,0,2,2,2,0,0,0,2024-01-08 15:10:00,0
5117,5119,5119,5119,2026,24,148,24,148,2026,0,24,118,118,118,24,24,148,0,31,31,0,24,7,7,7,7,7,0,2,2,2,0,0,0,2024-01-08 15:12:00,0
5116,5115,5115,5115,2022,24,145,24,145,2022,0,24,118,118,118,24,24,145,0,28,28,5,24,4,4,4,4,4,0,2,2,2,0,0,0,2024-01-08 15:14:00,0
5134,5134,5134,5134,2034,24,145,24,145,2034,0,24,119,119,119,24,24,145,0,27,27,0,24,3,3,3,3,3,0,2,2,2,0,0,0,2024-01-08 15:16:00,0
5144,5145,5145,5145,2039,24,247,24,146,2039,101,24,119,119,119,24,24,247,101,28,28,0,24,4,4,4,4,3,0,2,2,2,0,0,1,2024-01-08 15:18:00,0
5122,5122,5122,5122,2027,24,148,24,148,2027,0,24,118,118,118,24,24,148,0,31,31,0,24,7,7,7,7,7,0,2,2,2,0,0,0,2024-01-08 15:20:00,0
5109,5109,5109,5109,2020,24,246,24,145,2020,101,24,119,119,119,24,24,246,101,28,28,0,24,4,4,4,4,3,0,2,2,2,0,0,1,2024-01-08 15:22:00,0
5124,5124,5124,5124,2030,24,146,24,146,2030,0,24,118,118,118,24,24,146,0,28,28,5,24,4,4,4,4,4,0,2,2,2,0,0,0,2024-01-08 15:24:00,0
5142,5142,5142,5142,2036,24,149,24,149,2036,0,24,119,119,119,24,24,149,0,31,31,0,24,7,7,7,7,7,0,2,2,2,0,0,0,2024-01-08 15:26:00,0
5056,5055,5055,5055,1998,24,143,24,143,1998,0,24,117,117,117,24,24,143,0,28,28,0,24,4,4,4,4,4,0,2,2,2,0,0,0,2024-01-08 15:28:00,0
5112,5113,5112,5112,2022,24,145,24,145,2022,0,24,118,118,118,24,24,145,0,28,28,0,24,4,4,4,4,4,0,2,2,2,0,0,0,2024-01-08 15:30:00,0
5122,5122,5122,5122,2025,24,146,24,146,2025,0,24,118,118,118,24,24,146,0,28,28,0,24,4,4,4,4,3,0,2,2,2,0,0,1,2024-01-08 15:32:00,0
5125,5126,5126,5126,2030,24,148,24,148,2030,0,24,119,119,119,24,24,148,0,31,31,1,24,7,7,7,7,7,0,2,2,2,0,0,0,2024-01-08 15:34:00,0
5099,5097,5097,5097,2015,22,143,22,143,2015,0,22,118,118,118,22,22,143,0,27,27,0,22,3,3,3,3,3,0,2,2,2,0,0,0,2024-01-08 15:36:00,0
5106,5107,5107,5107,2021,24,145,24,145,2021,0,24,118,118,118,24,24,145,0,28,28,0,24,4,4,4,4,3,0,2,2,2,0,0,1,2024-01-08 15:38:00,0
5098,5098,5098,5098,2018,24,145,24,145,2018,0,24,118,118,118,24,24,145,0,28,28,2,24,4,4,4,4,4,0,2,2,2,0,0,0,2024-01-08 15:40:00,0
5107,5108,5108,5108,2020,24,149,24,149,2020,0,24,118,118,118,24,24,149,0,31,31,0,24,7,7,7,7,7,0,2,2,2,0,0,0,2024-01-08 15:42:00,0
5103,5103,5103,5103,2015,24,144,24,144,2015,0,24,118,118,118,24,24,144,0,28,28,0,24,4,4,4,4,4,0,2,2,2,0,0,0,2024-01-08 15:44:00,0
5126,5126,5126,5126,2030,24,146,24,146,2030,0,24,119,119,119,24,24,146,0,28,28,4,24,4,4,4,4,4,0,2,2,2,0,0,0,2024-01-08 15:46:00,0
5130,5129,5129,5129,2029,24,249,24,148,2029,101,24,118,118,118,24,24,249,101,31,31,0,24,7,7,7,7,6,0,2,2,2,0,0,1,2024-01-08 15:48:00,0
5130,5130,5130,5130,2031,24,146,24,146,2031,0,24,119,119,119,24,24,146,0,28,28,4,24,4,4,4,4,4,0,2,2,2,0,0,0,2024-01-08 15:50:00,0
5066,5067,5067,5067,2004,24,245,24,144,2004,101,24,117,117,117,24,24,245,101,28,28,0,24,4,4,4,4,4,0,2,2,2,0,0,0,2024-01-08 15:52:00,0
5119,5117,5117,5117,2028,24,145,24,145,2028,0,24,118,118,118,24,24,145,0,28,28,0,24,4,4,4,4,4,0,2,2,2,0,0,0,2024-01-08 15:54:00,0
5104,5105,5105,5105,2018,24,148,24,148,2018,0,24,119,119,119,24,24,148,0,31,31,4,24,7,7,7,7,7,0,2,2,2,0,0,0,2024-01-08 15:56:00,0
5120,5121,5121,5121,2026,24,145,24,145,2026,0,24,118,118,118,24,24,145,0,28,28,0,24,4,4,4,4,4,0,2,2,2,0,0,0,2024-01-08 15:58:00,0
5113,5131,5111,5111,2022,24,145,24,145,2022,0,24,118,118,118,24,24,145,0,28,28,0,24,4,4,4,4,3,0,2,2,2,0,0,1,2024-01-08 16:00:00,0
5104,5105,5105,5105,2018,22,447,22,144,2018,303,22,118,118,118,22,22,447,303,27,27,0,22,3,3,3,3,3,0,2,2,2,0,0,0,2024-01-08 16:02:00,0
5130,5131,5131,5131,2031,24,249,24,148,2031,101,24,119,119,119,24,24,249,101,31,31,1,24,7,7,7,7,7,0,2,2,2,0,0,0,2024-01-08 16:04:00,0
5115,5114,5114,5114,2025,24,145,24,145,2025,0,24,118,118,118,24,24,145,0,28,28,4,24,4,4,4,4,3,0,2,2,2,0,0,1,2024-01-08 16:06:00,0
5119,5138,5119,5119,2027,24,146,24,146,2027,0,24,119,119,119,24,24,146,0,28,28,0,24,4,4,4,4,4,0,2,2,2,0,0,0,2024-01-08 16:08:00,0
5137,5138,5138,5138,2035,24,148,24,148,2035,0,24,119,119,119,24,24,148,0,31,31,0,24,7,7,7,7,7,0,2,2,2,0,0,0,2024-01-08 16:10:00,0
5071,5071,5071,5071,2005,24,144,24,144,2005,0,24,117,117,117,24,24,144,0,28,28,0,24,4,4,4,4,4,0,2,2,2,0,0,0,2024-01-08 16:12:00,0
5116,5116,5116,5116,2023,24,145,24,145,2023,0,24,118,118,118,24,24,145,0,28,28,0,24,4,4,4,4,4,0,2,2,2,0,0,0,2024-01-08 16:14:00,0
5103,5104,5103,5103,2018,24,145,24,145,2018,0,24,118,118,118,24,24,145,0,28,28,5,24,4,4,4,4,3,0,2,2,2,0,0,1,2024-01-08 16:16:00,0
5131,5131,5131,5131,2033,24,149,24,149,2033,0,24,118,118,118,24,24,149,0,31,31,0,24,7,7,7,7,7,0,2,2,2,0,0,0,2024-01-08 16:18:00,0
5107,5107,5107,5107,2025,24,144,24,144,2025,0,24,119,119,119,24,24,144,0,27,27,0,24,3,3,3,3,3,0,2,2,2,0,0,0,2024-01-08 16:20:00,0
5297,5298,5298,5298,2094,24,150,24,150,2094,0,24,122,122,122,24,24,150,0,28,28,2,24,4,4,4,4,3,0,2,2,2,0,0,1,2024-01-08 16:22:00,0
5734,5734,5734,5734,2014,24,794,24,144,2014,650,24,119,118,118,24,24,794,650,28,28,0,24,4,4,4,4,4,0,2,2,2,1,1,0,2024-01-08 16:24:00,0
5864,5864,5864,5864,1992,24,978,24,147,1992,831,24,118,118,117,24,24,978,831,31,31,3,24,7,7,7,7,7,3,2,2,2,0,0,0,2024-01-08 16:26:00,0
5335,5335,5335,5335,2023,22,366,22,145,2023,221,22,118,118,118,22,22,366,221,28,28,0,22,4,4,4,4,4,0,2,2,2,0,0,0,2024-01-08 16:28:00,0
5291,5291,5291,5291,2015,24,339,24,144,2015,195,24,118,118,118,24,24,339,195,28,28,0,24,4,4,4,4,4,0,2,2,2,0,0,0,2024-01-08 16:30:00,0
5311,5310,5310,5310,2014,24,461,24,148,2014,313,24,118,118,118,24,24,461,313,31,31,4,24,7,7,7,7,6,0,2,2,2,0,0,1,2024-01-08 16:32:00,0
5264,5264,5264,5264,2003,24,338,24,144,2003,194,24,117,117,117,24,24,338,194,28,28,0,24,4,4,4,4,4,0,2,2,2,0,0,0,2024-01-08 16:34:00,0
5305,5306,5306,5306,2020,24,343,24,143,2020,200,24,118,118,118,24,24,343,200,27,27,2,24,3,3,3,3,3,0,2,2,2,0,0,0,2024-01-08 16:36:00,0
5366,5365,5365,5365,2022,24,399,24,145,2022,254,24,119,119,119,24,24,399,254,28,28,0,24,4,4,4,4,3,0,2,2,2,0,0,1,2024-01-08 16:38:00,0
5359,5359,5359,5359,2032,24,377,24,150,2032,227,24,118,118,118,24,24,377,227,32,32,0,24,8,8,8,8,8,0,2,2,2,0,0,0,2024-01-08 16:40:00,0
5348,5348,5348,5348,2013,24,401,24,144,2013,257,24,118,118,118,24,24,401,257,27,27,4,24,3,3,3,3,3,0,2,2,2,0,0,0,2024-01-08 16:42:00,0
5346,5346,5346,5346,2020,24,384,24,145,2020,239,24,118,118,118,24,24,384,239,28,28,0,24,4,4,4,4,4,0,2,2,2,0,0,0,2024-01-08 16:44:00,0
5350,5351,5351,5351,2034,24,361,24,146,2034,215,24,119,119,119,24,24,361,215,28,28,0,24,4,4,4,4,4,0,2,2,2,0,0,0,2024-01-08 16:46:00,0
5363,5362,5362,5362,2035,24,478,24,149,2035,329,24,119,119,119,24,24,478,329,31,31,4,24,7,7,7,7,6,0,2,2,2,0,0,1,2024-01-08 16:48:00,0
5335,5336,5336,5336,2030,24,351,24,145,2030,206,24,118,118,118,24,24,351,206,28,28,0,24,4,4,4,4,4,0,2,2,2,0,0,0,2024-01-08 16:50:00,0
5369,5369,5369,5369,2020,24,405,24,145,2020,260,24,118,118,118,24,24,405,260,28,28,4,24,4,4,4,4,4,0,2,2,2,0,0,0,2024-01-08 16:52:00,0
5300,5300,5300,5300,2020,22,342,22,148,2020,194,22,118,118,118,22,22,342,194,31,31,0,22,7,7,7,7,7,0,2,2,2,0,0,0,2024-01-08 16:54:00,0
5317,5315,5315,5315,1997,24,406,24,143,1997,263,24,117,117,117,24,24,406,263,28,28,0,24,4,4,4,4,4,0,2,2,2,0,0,0,2024-01-08 16:56:00,0
5316,5318,5318,5318,2015,24,363,24,145,2015,218,24,118,118,118,24,24,363,218,28,28,0,24,4,4,4,4,4,0,2,2,2,0,0,0,2024-01-08 16:58:00,0
5352,5352,5352,5352,2022,24,386,24,145,2022,241,24,118,118,118,24,24,386,241,28,28,1,24,4,4,4,4,3,0,2,2,2,0,0,1,2024-01-08 17:00:00,0
5287,5287,5287,5287,2004,24,459,24,147,2004,312,24,118,118,118,24,24,459,312,31,31,4,24,7,7,7,7,7,0,2,2,2,0,0,0,2024-01-08 17:02:00,0
5338,5337,5337,5337,2021,24,375,24,144,2021,231,24,118,118,118,24,24,375,231,27,27,0,24,3,3,3,3,3,0,2,2,2,0,0,0,2024-01-08 17:04:00,0
5359,5360,5360,5360,2011,24,417,24,144,2011,273,24,118,118,118,24,24,417,273,28,28,0,24,4,4,4,4,3,0,2,2,2,0,0,1,2024-01-08 17:06:00,0
5452,5452,5452,5452,2007,24,512,24,144,2007,368,24,118,118,118,24,24,512,368,28,28,4,24,4,4,4,4,4,0,2,2,2,0,0,0,2024-01-08 17:08:00,0
5359,5358,5358,5358,2020,24,402,24,147,2020,255,24,118,118,118,24,24,402,255,31,31,0,24,7,7,7,7,7,0,2,2,2,0,0,0,2024-01-08 17:10:00,0
5383,5385,5384,5384,2010,24,438,24,145,2010,293,24,117,117,117,24,24,438,293,28,28,3,24,4,4,4,4,4,0,2,2,2,0,0,0,2024-01-08 17:12:00,0
5486,5485,5485,5485,2025,24,517,24,145,2025,372,24,119,119,119,24,24,517,372,28,28,1,24,4,4,4,4,4,0,2,2,2,0,0,0,2024-01-08 17:14:00,0
5333,5332,5332,5332,2017,24,377,24,147,2017,230,24,118,118,118,24,24,377,230,31,31,0,24,7,7,7,7,6,0,2,2,2,0,0,1,2024-01-08 17:16:00,0
5376,5377,5376,5376,2033,22,397,22,146,2033,251,22,118,118,118,22,22,397,251,28,28,4,22,4,4,4,4,4,0,2,2,2,0,0,0,2024-01-08 17:18:00,0
5231,5233,5233,5233,2019,24,279,24,143,2019,136,24,118,118,118,24,24,279,136,26,26,0,24,3,3,3,3,3,0,2,2,2,0,0,0,2024-01-08 17:20:00,0
5226,5226,5226,5226,2015,24,274,24,145,2015,129,24,118,118,118,24,24,274,129,28,28,0,24,4,4,4,4,3,0,2,2,2,0,0,1,2024-01-08 17:22:00,0
5273,5272,5272,5272,2028,24,302,24,150,2028,152,24,119,119,119,24,24,302,152,33,33,4,24,8,8,8,8,8,0,2,2,2,0,0,0,2024-01-08 17:24:00,0
5183,5182,5182,5182,2017,24,225,24,144,2017,81,24,117,117,117,24,24,225,81,27,27,0,24,3,3,3,3,3,0,2,2,2,0,0,0,2024-01-08 17:26:00,0
5187,5189,5189,5189,2027,24,207,24,145,2027,62,24,119,119,119,24,24,207,62,28,28,2,24,4,4,4,4,4,0,2,2,2,0,0,0,2024-01-08 17:28:00,0
5137,5136,5136,5136,2022,24,176,24,148,2022,28,24,118,118,118,24,24,176,28,31,31,0,24,7,7,7,7,7,0,2,2,2,0,0,0,2024-01-08 17:30:00,0
5171,5172,5172,5172,2022,24,207,24,145,2022,62,24,118,118,118,24,24,207,62,28,28,0,24,4,4,4,4,3,0,2,2,2,0,0,1,2024-01-08 17:32:00,0
5143,5143,5143,5143,2032,24,156,24,145,2032,11,24,119,119,119,24,24,156,11,28,28,2,24,4,4,4,4,4,0,2,2,2,0,0,0,2024-01-08 17:34:00,0
5121,5120,5120,5120,2022,24,154,24,145,2022,9,24,118,118,118,24,24,154,9,28,28,0,24,4,4,4,4,3,0,2,2,2,0,0,1,2024-01-08 17:36:00,0
5126,5127,5127,5127,2025,24,158,24,149,2025,9,24,118,118,118,24,24,158,9,31,31,2,24,7,7,7,7,7,0,2,2,2,0,0,0,2024-01-08 17:38:00,0
5126,5126,5126,5126,2019,24,163,24,144,2019,19,24,118,118,118,24,24,163,19,28,28,0,24,4,4,4,4,4,0,2,2,2,0,0,0,2024-01-08 17:40:00,0
5108,5108,5108,5108,2019,24,145,24,145,2019,0,24,118,118,118,24,24,145,0,27,27,0,24,3,3,3,3,3,0,2,2,2,0,0,0,2024-01-08 17:42:00,0
5134,5134,5133,5133,2035,22,145,22,145,2035,0,22,119,119,119,22,22,145,0,28,28,0,22,4,4,4,4,4,0,2,2,2,0,0,0,2024-01-08 17:44:00,0
5065,5087,5066,5066,2004,24,146,24,146,2004,0,24,117,117,117,24,24,146,0,30,30,0,24,7,7,7,7,7,0,2,2,2,0,0,0,2024-01-08 17:46:00,0
5133,5132,5132,5132,2031,24,150,24,146,2031,4,24,119,119,119,24,24,150,4,28,28,2,24,4,4,4,4,3,0,2,2,2,0,0,1,2024-01-08 17:48:00,0
5147,5147,5146,5146,2042,24,145,24,145,2042,0,24,119,119,119,24,24,145,0,28,28,1,24,4,4,4,4,4,0,2,2,2,0,0,0,2024-01-08 17:50:00,0
5145,5146,5146,5146,2037,24,159,24,149,2037,10,24,118,118,118,24,24,159,10,31,31,0,24,7,7,7,7,7,0,2,2,2,0,0,0,2024-01-08 17:52:00,0
5125,5126,5126,5126,2027,24,145,24,145,2027,0,24,119,119,119,24,24,145,0,28,28,4,24,4,4,4,4,3,0,2,2,2,0,0,1,2024-01-08 17:54:00,0
5141,5141,5141,5141,2036,24,149,24,146,2036,3,24,118,118,118,24,24,149,3,28,28,0,24,4,4,4,4,4,0,2,2,2,0,0,0,2024-01-08 17:56:00,0
5284,5283,5283,5283,2025,24,311,24,145,2025,166,24,124,120,118,24,24,311,166,28,28,0,24,4,4,4,4,3,6,2,2,2,4,4,1,2024-01-08 17:58:00,0
5259,5259,5259,5259,2026,24,278,24,148,2026,130,24,128,124,120,24,24,278,130,31,31,4,24,7,7,7,7,7,12,2,2,2,4,4,0,2024-01-08 18:00:00,0
5248,5249,5249,5249,2013,24,287,24,145,2013,142,24,131,122,118,24,24,287,142,28,28,1,24,4,4,4,4,4,12,2,2,2,9,9,0,2024-01-08 18:02:00,0
5203,5202,5202,5202,2014,24,234,24,144,2014,90,24,135,124,119,24,24,234,90,27,27,3,24,3,3,3,3,3,15,2,2,2,11,11,0,2024-01-08 18:04:00,0
5229,5230,5230,5230,2027,24,246,24,145,2027,101,24,127,121,118,24,24,246,101,28,28,0,24,4,4,4,4,4,9,2,2,2,6,6,0,2024-01-08 18:06:00,0
5226,5226,5226,5226,2018,24,262,24,148,2018,114,24,130,122,118,24,24,262,114,31,31,0,24,7,7,7,7,7,12,2,2,2,8,8,0,2024-01-08 18:08:00,0
5194,5193,5193,5193,2002,22,262,22,144,2002,118,22,129,122,119,22,22,262,118,28,28,0,22,4,4,4,4,3,9,2,2,2,7,7,1,2024-01-08 18:10:00,0
5217,5217,5217,5217,2014,24,264,24,144,2014,120,24,121,118,117,24,24,264,120,28,28,0,24,4,4,4,4,4,3,2,2,2,3,3,0,2024-01-08 18:12:00,0
5257,5258,5258,5258,2021,24,275,24,148,2021,127,24,134,121,120,24,24,275,127,31,31,2,24,7,7,7,7,6,3,2,2,2,13,13,1,2024-01-08 18:14:00,0
5275,5275,5275,5275,2033,24,278,24,146,2033,132,24,130,122,119,24,24,278,132,28,28,1,24,4,4,4,4,4,9,2,2,2,8,8,0,2024-01-08 18:16:00,0
5258,5257,5257,5257,2030,24,267,24,145,2030,122,24,126,120,119,24,24,267,122,28,28,0,24,4,4,4,4,4,3,2,2,2,6,6,0,2024-01-08 18:18:00,0
5252,5253,5253,5253,2028,24,262,24,145,2028,117,24,128,123,118,24,24,262,117,27,27,2,24,3,3,3,3,3,15,2,2,2,5,5,0,2024-01-08 18:20:00,0
5238,5238,5238,5238,2009,24,285,24,148,2009,137,24,130,120,118,24,24,285,137,32,32,0,24,8,8,8,8,8,6,2,2,2,10,10,0,2024-01-08 18:22:00,0
5286,5284,5284,5284,2028,24,286,24,145,2028,141,24,141,124,119,24,24,286,141,27,27,0,24,3,3,3,3,3,15,2,2,2,17,17,0,2024-01-08 18:24:00,0
5252,5254,5254,5254,2018,24,286,24,144,2018,142,24,126,122,119,24,24,286,142,28,28,4,24,4,4,4,4,3,9,2,2,2,4,4,1,2024-01-08 18:26:00,0
5268,5268,5268,5268,2030,24,279,24,149,2030,130,24,127,122,119,24,24,279,130,31,31,0,24,7,7,7,7,7,9,2,2,2,5,5,0,2024-01-08 18:28:00,0
5255,5254,5254,5254,2025,24,271,24,145,2025,126,24,127,121,118,24,24,271,126,28,28,2,24,4,4,4,4,3,9,2,2,2,6,6,1,2024-01-08 18:30:00,0
5191,5211,5191,5191,1999,24,258,24,144,1999,114,24,134,118,117,24,24,258,114,28,28,0,24,4,4,4,4,4,3,2,2,2,16,16,0,2024-01-08 18:32:00,0
5250,5251,5251,5251,2023,22,272,22,145,2023,127,22,129,123,119,22,22,272,127,28,28,0,22,4,4,4,4,4,12,2,2,2,6,6,0,2024-01-08 18:34:00,0
5260,5260,5260,5260,2021,24,283,24,148,2021,135,24,130,121,118,24,24,283,135,31,31,4,24,7,7,7,7,7,9,2,2,2,9,9,0,2024-01-08 18:36:00,0
5246,5246,5246,5246,2027,24,260,24,145,2027,115,24,128,119,118,24,24,260,115,28,28,0,24,4,4,4,4,4,3,2,2,2,9,9,0,2024-01-08 18:38:00,0
5258,5256,5256,5256,2019,24,280,24,144,2019,136,24,130,121,118,24,24,280,136,27,27,4,24,3,3,3,3,3,9,2,2,2,9,9,0,2024-01-08 18:40:00,0
5236,5238,5238,5238,2019,24,262,24,145,2019,117,24,131,120,118,24,24,262,117,28,28,0,24,4,4,4,4,3,6,2,2,2,11,11,1,2024-01-08 18:42:00,0
5246,5245,5245,5245,2021,24,270,24,148,2021,122,24,133,120,119,24,24,270,122,31,31,0,24,7,7,7,7,7,3,2,2,2,13,13,0,2024-01-08 18:44:00,0
5243,5243,5243,5243,2018,24,276,24,145,2018,131,24,126,122,118,24,24,276,131,28,28,0,24,4,4,4,4,3,12,2,2,2,4,4,1,2024-01-08 18:46:00,0
5272,5272,5272,5272,2031,24,373,24,145,2031,228,24,132,121,118,24,24,373,228,28,28,0,24,4,4,4,4,4,9,2,2,2,11,11,0,2024-01-08 18:48:00,0
5254,5256,5255,5255,2021,24,278,24,148,2021,130,24,130,118,118,24,24,278,130,31,31,2,24,7,7,7,7,7,0,2,2,2,12,12,0,2024-01-08 18:50:00,0
5272,5271,5271,5271,2024,24,346,24,146,2024,200,24,128,120,119,24,24,346,149,29,29,1,24,5,5,4,4,4,3,2,2,2,8,8,0,2024-01-08 18:52:00,52
5256,5254,5254,5254,2024,24,274,24,145,2024,129,24,131,121,119,24,24,274,129,28,28,0,24,4,4,4,4,4,6,2,2,2,10,10,0,2024-01-08 18:54:00,0
5223,5226,5226,5226,2013,24,268,24,144,2013,124,24,128,119,117,24,24,268,124,27,27,4,24,3,3,3,3,3,6,2,2,2,9,9,0,2024-01-08 18:56:00,0
5233,5230,5230,5230,2028,24,248,23,149,2028,99,23,130,121,120,23,23,248,99,32,32,0,23,8,8,8,8,8,3,2,2,2,9,9,0,2024-01-08 18:58:00,0
5247,5250,5250,5250,2024,22,270,23,144,2024,126,23,125,122,119,23,23,270,126,27,27,0,23,3,3,3,3,3,9,2,2,2,3,3,0,2024-01-08 19:00:00,0
5235,5233,5233,5233,2015,24,571,24,145,2015,426,24,127,119,118,24,24,571,426,28,28,2,24,4,4,4,4,3,3,2,2,2,8,8,1,2024-01-08 19:02:00,0
5246,5247,5247,5247,2024,24,363,24,145,2024,218,24,133,125,120,24,24,363,218,28,28,0,24,4,4,4,4,4,15,2,2,2,8,8,0,2024-01-08 19:04:00,0
5227,5228,5228,5228,2018,24,264,24,148,2018,116,24,129,123,119,24,24,264,116,31,31,3,24,7,7,7,7,6,12,2,2,2,6,6,1,2024-01-08 19:06:00,0
5273,5272,5272,5272,2025,24,283,24,145,2025,138,24,132,120,119,24,24,283,138,28,28,0,24,4,4,4,4,4,3,2,2,2,12,12,0,2024-01-08 19:08:00,0
5233,5234,5234,5234,2026,24,248,24,145,2026,103,24,129,123,118,24,24,248,103,28,28,0,24,4,4,4,4,4,15,2,2,2,6,6,0,2024-01-08 19:10:00,0
5225,5225,5225,5225,2025,24,246,24,148,2025,98,24,131,123,119,24,24,246,98,31,31,4,24,7,7,7,7,7,12,2,2,2,8,8,0,2024-01-08 19:12:00,0
5221,5221,5221,5221,2011,24,265,24,144,2011,121,24,125,118,117,24,24,265,121,28,28,0,24,4,4,4,4,4,3,2,2,2,7,7,0,2024-01-08 19:14:00,0
5263,5262,5262,5262,2011,24,291,24,144,2011,147,24,142,118,118,24,24,291,147,27,27,4,24,3,3,3,3,3,0,2,2,2,24,24,0,2024-01-08 19:16:00,0
5224,5224,5224,5224,2018,24,357,24,144,2018,213,24,130,121,119,24,24,357,213,28,28,0,24,4,4,4,4,3,6,2,2,2,9,9,1,2024-01-08 19:18:00,0
5223,5224,5224,5224,2007,24,283,24,147,2007,136,24,129,120,118,24,24,283,136,31,31,0,24,7,7,7,7,7,6,2,2,2,9,9,0,2024-01-08 19:20:00,0
5201,5200,5200,5200,2008,24,248,24,145,2008,103,24,128,119,117,24,24,248,103,28,28,4,24,4,4,4,4,3,6,2,2,2,9,9,1,2024-01-08 19:22:00,0
5267,5268,5268,5268,2022,22,283,22,145,2022,138,22,138,127,121,22,22,283,138,28,28,0,22,4,4,4,4,4,18,2,2,2,11,11,0,2024-01-08 19:24:00,0
5245,5244,5244,5244,2020,24,271,24,144,2020,127,24,133,121,118,24,24,271,127,28,28,0,24,4,4,4,4,4,9,2,2,2,12,12,0,2024-01-08 19:26:00,0
5247,5247,5247,5247,2023,24,267,24,148,2023,119,24,131,121,118,24,24,267,119,31,31,2,24,7,7,7,7,7,9,2,2,2,10,10,0,2024-01-08 19:28:00,0
5258,5259,5259,5259,2032,24,273,24,146,2032,127,24,123,120,119,24,24,273,127,28,28,0,24,4,4,4,4,4,3,2,2,2,3,3,0,2024-01-08 19:30:00,0
5254,5254,5254,5254,2027,24,266,24,145,2027,121,24,130,121,120,24,24,266,121,28,28,5,24,4,4,4,4,3,3,2,2,2,9,9,1,2024-01-08 19:32:00,0
5207,5207,5207,5207,2010,24,257,24,148,2010,109,24,129,120,118,24,24,257,109,31,31,0,24,7,7,7,7,7,6,2,2,2,9,9,0,2024-01-08 19:34:00,0
5246,5244,5244,5244,2027,24,258,24,144,2027,114,24,130,121,118,24,24,258,114,27,27,0,24,3,3,3,3,3,9,2,2,2,9,9,0,2024-01-08 19:36:00,0
5238,5239,5239,5239,2023,24,364,24,145,2023,219,24,125,120,118,24,24,364,219,28,28,2,24,4,4,4,4,3,6,2,2,2,5,5,1,2024-01-08 19:38:00,0
5239,5239,5239,5239,2016,24,271,24,144,2016,127,24,131,121,118,24,24,271,127,28,28,0,24,4,4,4,4,4,9,2,2,2,10,10,0,2024-01-08 19:40:00,0
5210,5211,5211,5211,2004,24,271,24,147,2004,124,24,128,122,119,24,24,271,124,31,31,0,24,7,7,7,7,7,9,2,2,2,6,6,0,2024-01-08 19:42:00,0
5232,5232,5232,5232,2016,24,270,24,145,2016,125,24,134,122,119,24,24,270,125,28,28,0,24,4,4,4,4,4,9,2,2,2,12,12,0,2024-01-08 19:44:00,0
5239,5239,5239,5239,2028,24,259,24,145,2028,114,24,125,121,119,24,24,259,114,28,28,1,24,4,4,4,4,4,6,2,2,2,4,4,0,2024-01-08 19:46:00,0
5225,5225,5225,5225,2023,24,250,24,149,2023,101,24,127,119,118,24,24,250,101,31,31,2,24,7,7,7,7,6,3,2,2,2,8,8,1,2024-01-08 19:48:00,0
5236,5235,5235,5235,2019,22,264,22,144,2019,120,22,129,120,119,22,22,264,120,28,28,0,22,4,4,4,4,4,3,2,2,2,9,9,0,2024-01-08 19:50:00,0
5259,5259,5259,5259,2021,24,278,24,145,2021,133,24,132,122,118,24,24,278,133,28,28,2,24,4,4,4,4,4,12,2,2,2,10,10,0,2024-01-08 19:52:00,0
5243,5244,5244,5244,2019,24,274,24,145,2019,129,24,127,119,119,24,24,274,129,28,28,0,24,4,4,4,4,4,0,2,2,2,8,8,0,2024-01-08 19:54:00,0
5231,5231,5231,5231,2023,24,252,24,148,2023,104,24,131,123,118,24,24,252,104,31,31,0,24,7,7,7,7,7,15,2,2,2,8,8,0,2024-01-08 19:56:00,0
5219,5219,5219,5219,2017,24,249,24,145,2017,104,24,128,120,118,24,24,249,104,28,28,3,24,4,4,4,4,4,6,2,2,2,8,8,0,2024-01-08 19:58:00,0
5238,5238,5238,5238,2021,24,261,24,145,2021,116,24,131,122,120,24,24,261,116,28,28,0,24,4,4,4,4,3,6,2,2,2,9,9,1,2024-01-08 20:00:00,0
5229,5229,5229,5229,2006,24,580,24,143,2006,437,24,130,122,118,24,24,580,437,27,27,0,24,3,3,3,3,3,12,2,2,2,8,8,0,2024-01-08 20:02:00,0
5276,5276,5276,5276,2034,24,275,24,149,2034,126,24,132,124,119,24,24,275,126,31,31,4,24,7,7,7,7,7,15,2,2,2,8,8,0,2024-01-08 20:04:00,0
5244,5244,5244,5244,2028,24,254,24,145,2028,109,24,134,119,118,24,24,254,109,28,28,0,24,4,4,4,4,3,3,2,2,2,15,15,1,2024-01-08 20:06:00,0
5231,5231,5231,5231,2017,24,363,24,144,2017,219,24,138,125,118,24,24,363,219,27,27,4,24,4,4,4,4,4,21,2,2,2,13,13,0,2024-01-08 20:08:00,0
5230,5230,5230,5230,2017,24,264,24,147,2017,117,24,130,119,119,24,24,264,117,31,31,0,24,7,7,7,7,7,0,2,2,2,11,11,0,2024-01-08 20:10:00,0
5253,5253,5253,5253,2031,24,262,24,146,2031,116,24,129,119,118,24,24,262,116,28,28,0,24,4,4,4,4,4,3,2,2,2,10,10,0,2024-01-08 20:12:00,0
5225,5224,5224,5224,2022,22,252,22,144,2022,108,22,127,124,118,22,22,252,108,28,28,2,22,4,4,4,4,4,18,2,2,2,3,3,0,2024-01-08 20:14:00,0
5277,5278,5278,5278,2015,24,301,24,145,2015,156,24,135,122,118,24,24,301,156,28,28,0,24,4,4,4,4,3,12,2,2,2,13,13,1,2024-01-08 20:16:00,0
5257,5256,5256,5256,2015,24,292,24,148,2015,144,24,133,123,118,24,24,292,144,31,31,4,24,7,7,7,7,7,15,2,2,2,10,10,0,2024-01-08 20:18:00,0
5240,5240,5240,5240,2016,24,276,24,143,2016,133,24,128,122,118,24,24,276,133,27,27,0,24,3,3,3,3,3,12,2,2,2,6,6,0,2024-01-08 20:20:00,0
5211,5212,5212,5212,2006,24,263,24,145,2006,118,24,126,120,118,24,24,263,118,28,28,0,24,4,4,4,4,3,6,2,2,2,6,6,1,2024-01-08 20:22:00,0
5255,5255,5255,5255,2026,24,270,24,145,2026,125,24,127,122,120,24,24,270,125,28,28,4,24,4,4,4,4,4,6,2,2,2,5,5,0,2024-01-08 20:24:00,0
5253,5252,5252,5252,2023,24,272,24,149,2023,123,24,133,121,118,24,24,272,123,32,32,0,24,7,7,7,7,7,9,2,2,2,12,12,0,2024-01-08 20:26:00,0
5228,5229,5229,5229,2022,24,248,24,145,2022,103,24,129,118,118,24,24,248,103,28,28,1,24,4,4,4,4,4,0,2,2,2,11,11,0,2024-01-08 20:28:00,0
5234,5233,5233,5233,2023,24,252,24,145,2023,107,24,130,123,119,24,24,252,107,28,28,1,24,4,4,4,4,4,12,2,2,2,7,7,0,2024-01-08 20:30:00,0
5239,5238,5238,5238,2021,24,278,24,147,2021,131,24,130,120,118,24,24,278,131,30,30,0,24,7,7,7,7,6,6,2,2,2,10,10,1,2024-01-08 20:32:00,0
5215,5217,5217,5217,2021,24,240,24,145,2021,95,24,128,119,118,24,24,240,95,28,28,4,24,4,4,4,4,4,3,2,2,2,9,9,0,2024-01-08 20:34:00,0
5271,5271,5271,5271,2035,24,264,24,145,2035,119,24,133,120,119,24,24,264,119,27,27,0,24,3,3,3,3,3,3,2,2,2,13,13,0,2024-01-08 20:36:00,0
5265,5265,5265,5265,2032,24,365,24,145,2032,220,24,133,121,119,24,24,365,220,28,28,0,24,4,4,4,4,3,6,2,2,2,12,12,1,2024-01-08 20:38:00,0
5237,5236,5236,5236,2027,23,250,23,149,2027,101,23,130,118,118,23,23,250,101,32,32,2,23,8,8,8,8,8,0,2,2,2,12,12,0,2024-01-08 20:40:00,0
5230,5231,5231,5231,2017,23,265,23,144,2017,121,23,128,120,119,23,23,265,121,27,27,0,23,3,3,3,3,3,3,2,2,2,8,8,0,2024-01-08 20:42:00,0
5248,5247,5247,5247,2026,24,257,24,145,2026,112,24,132,122,119,24,24,257,112,28,28,4,24,4,4,4,4,4,9,2,2,2,10,10,0,2024-01-08 20:44:00,0
5263,5264,5264,5264,2025,24,285,24,148,2025,137,24,128,121,119,24,24,285,137,31,31,0,24,7,7,7,7,7,6,2,2,2,7,7,0,2024-01-08 20:46:00,0
5227,5227,5227,5227,2024,24,244,24,146,2024,98,24,132,123,118,24,24,244,98,28,28,0,24,4,4,4,4,3,15,2,2,2,9,9,1,2024-01-08 20:48:00,0
5234,5233,5233,5233,2023,24,255,24,144,2023,111,24,130,121,119,24,24,255,111,28,28,4,24,4,4,4,4,4,6,2,2,2,9,9,0,2024-01-08 20:50:00,0
5252,5253,5253,5253,2031,24,355,24,146,2031,209,24,131,121,118,24,24,355,209,28,28,0,24,4,4,4,4,4,9,2,2,2,10,10,0,2024-01-08 20:52:00,0
5261,5260,5260,5260,2029,24,271,24,149,2029,122,24,131,121,119,24,24,271,122,31,31,3,24,7,7,7,7,6,6,2,2,2,10,10,1,2024-01-08 20:54:00,0
5207,5208,5208,5208,2004,24,276,24,143,2004,133,24,130,120,117,24,24,276,133,28,28,1,24,4,4,4,4,4,9,2,2,2,10,10,0,2024-01-08 20:56:00,0
5237,5237,5237,5237,2021,24,257,24,145,2021,112,24,132,123,118,24,24,257,112,28,28,0,24,4,4,4,4,3,15,2,2,2,9,9,1,2024-01-08 20:58:00,0
5248,5244,5244,5244,2018,24,269,24,144,2018,125,24,132,123,118,24,24,269,125,27,27,4,24,3,3,3,3,3,15,2,2,2,9,9,0,2024-01-08 21:00:00,0
5223,5227,5227,5227,2000,24,691,24,149,2000,542,24,131,120,118,24,24,691,542,32,32,0,24,8,8,8,8,8,6,2,2,2,11,11,0,2024-01-08 21:02:00,0
5251,5251,5251,5251,2029,24,357,24,144,2029,213,24,129,122,119,24,24,357,213,27,27,0,24,3,3,3,3,3,9,2,2,2,7,7,0,2024-01-08 21:04:00,0
5249,5249,5249,5249,2035,22,250,22,146,2035,104,22,130,122,120,22,22,250,104,28,28,0,22,4,4,4,4,4,6,2,2,2,8,8,0,2024-01-08 21:06:00,0
5256,5256,5256,5256,2029,24,260,24,148,2029,112,24,135,125,121,24,24,260,112,31,31,0,24,7,7,7,7,7,12,2,2,2,10,10,0,2024-01-08 21:08:00,0
5244,5244,5244,5244,2029,24,249,24,146,2029,103,24,135,122,118,24,24,249,103,28,28,5,24,4,4,4,4,3,12,2,2,2,13,13,1,2024-01-08 21:10:00,0
5235,5235,5235,5235,2019,24,266,24,144,2019,122,24,126,121,118,24,24,266,122,28,28,0,24,4,4,4,4,4,9,2,2,2,5,5,0,2024-01-08 21:12:00,0
5225,5224,5224,5224,2026,24,247,24,145,2026,102,24,124,122,119,24,24,247,102,28,28,0,24,4,4,4,4,3,9,2,2,2,2,2,1,2024-01-08 21:14:00,0
5259,5257,5257,5257,2024,24,281,24,148,2024,133,24,129,122,118,24,24,281,133,31,31,0,24,7,7,7,7,7,12,2,2,2,7,7,0,2024-01-08 21:16:00,0
5259,5262,5262,5262,2023,24,283,24,145,2023,138,24,127,120,118,24,24,283,138,28,28,0,24,4,4,4,4,4,6,2,2,2,7,7,0,2024-01-08 21:18:00,0
5224,5224,5224,5224,2014,24,273,24,144,2014,129,24,129,120,119,24,24,273,129,27,27,1,24,3,3,3,3,3,3,2,2,2,9,9,0,2024-01-08 21:20:00,0
5219,5219,5219,5219,2007,24,268,24,144,2007,124,24,132,120,118,24,24,268,124,28,28,0,24,4,4,4,4,4,6,2,2,2,12,12,0,2024-01-08 21:22:00,0
5243,5242,5242,5242,2023,24,260,24,148,2023,112,24,133,124,118,24,24,260,112,31,31,0,24,7,7,7,7,7,18,2,2,2,9,9,0,2024-01-08 21:24:00,0
5237,5236,5236,5236,2011,24,276,24,145,2011,131,24,135,123,118,24,24,276,131,28,28,4,24,4,4,4,4,3,15,2,2,2,12,12,1,2024-01-08 21:26:00,0
5256,5258,5258,5258,2018,24,284,24,145,2018,139,24,134,121,118,24,24,284,139,28,28,0,24,4,4,4,4,4,9,2,2,2,13,13,0,2024-01-08 21:28:00,0
5261,5261,5261,5261,2031,24,274,24,148,2031,126,24,125,120,119,24,24,274,126,31,31,3,24,7,7,7,7,6,3,2,2,2,5,5,1,2024-01-08 21:30:00,0
5221,5221,5221,5221,2018,22,352,22,145,2018,207,22,130,118,118,22,22,352,207,28,28,1,22,4,4,4,4,4,0,2,2,2,12,12,0,2024-01-08 21:32:00,0
5267,5266,5266,5266,2030,24,272,24,145,2030,127,24,130,120,119,24,24,272,127,28,28,0,24,4,4,4,4,4,3,2,2,2,10,10,0,2024-01-08 21:34:00,0
5241,5242,5242,5242,2035,24,243,24,145,2035,98,24,125,121,118,24,24,243,98,27,27,4,24,3,3,3,3,3,9,2,2,2,4,4,0,2024-01-08 21:36:00,0
5227,5225,5225,5225,2031,24,237,24,149,2031,88,24,131,122,119,24,24,237,88,32,32,0,24,8,8,8,8,8,9,2,2,2,9,9,0,2024-01-08 21:38:00,0
5258,5258,5258,5258,2021,24,277,24,144,2021,133,24,130,121,118,24,24,277,133,27,27,0,24,3,3,3,3,3,9,2,2,2,9,9,0,2024-01-08 21:40:00,0
5237,5239,5239,5239,2005,24,386,24,145,2005,241,24,135,124,118,24,24,386,241,28,28,4,24,4,4,4,4,3,18,2,2,2,11,11,1,2024-01-08 21:42:00,0
5202,5202,5202,5202,2006,24,268,24,147,2006,121,24,129,119,117,24,24,268,121,31,31,0,24,7,7,7,7,7,6,2,2,2,10,10,0,2024-01-08 21:44:00,0
5252,5251,5251,5251,2024,24,260,24,145,2024,115,24,137,124,119,24,24,260,115,28,28,2,24,4,4,4,4,3,15,2,2,2,13,13,1,2024-01-08 21:46:00,0
5215,5215,5215,5215,2023,24,241,24,145,2023,96,24,127,120,119,24,24,241,96,28,28,0,24,4,4,4,4,4,3,2,2,2,7,7,0,2024-01-08 21:48:00,0
5241,5242,5242,5242,2020,24,267,24,145,2020,122,24,129,119,118,24,24,267,122,28,28,0,24,4,4,4,4,4,3,2,2,2,10,10,0,2024-01-08 21:50:00,0
5261,5261,5261,5261,2018,24,340,24,148,2018,192,24,132,124,119,24,24,340,141,32,32,4,24,8,8,7,7,7,15,2,2,2,8,8,0,2024-01-08 21:52:00,52
5226,5226,5226,5226,2019,24,261,24,145,2019,116,24,124,118,118,24,24,261,116,28,28,0,24,4,4,4,4,4,0,2,2,2,6,6,0,2024-01-08 21:54:00,0
5230,5229,5229,5229,2020,24,254,24,144,2020,110,24,128,121,120,24,24,254,110,27,27,2,24,3,3,3,3,3,3,2,2,2,7,7,0,2024-01-08 21:56:00,0
5234,5235,5235,5235,2031,22,249,22,145,2031,104,22,126,119,119,22,22,249,104,28,28,0,22,4,4,4,4,4,0,2,2,2,7,7,0,2024-01-08 21:58:00,0
5230,5230,5230,5230,2017,24,264,24,148,2017,116,24,129,121,118,24,24,264,116,31,31,0,24,7,7,7,7,7,9,2,2,2,8,8,0,2024-01-08 22:00:00,0
5213,5213,5213,5213,2014,24,653,24,145,2014,508,24,126,119,118,24,24,653,508,28,28,4,24,4,4,4,4,3,3,2,2,2,7,7,1,2024-01-08 22:02:00,0
5241,5240,5240,5240,2028,24,254,24,146,2028,108,24,128,121,120,24,24,254,108,28,28,0,24,4,4,4,4,4,3,2,2,2,7,7,0,2024-01-08 22:04:00,0
5254,5255,5255,5255,2029,24,268,24,148,2029,120,24,128,120,119,24,24,268,120,31,31,1,24,7,7,7,7,6,3,2,2,2,8,8,1,2024-01-08 22:06:00,0
5172,5172,5172,5172,2009,24,237,24,144,2009,93,24,124,118,117,24,24,237,93,28,28,1,24,4,4,4,4,4,3,2,2,2,6,6,0,2024-01-08 22:08:00,0
5261,5260,5260,5260,2029,24,261,24,145,2029,116,24,138,124,119,24,24,261,116,28,28,0,24,4,4,4,4,4,15,2,2,2,14,14,0,2024-01-08 22:10:00,0
5209,5209,5209,5209,2010,24,254,24,144,2010,110,24,129,121,119,24,24,254,110,27,27,4,24,3,3,3,3,3,6,2,2,2,8,8,0,2024-01-08 22:12:00,0
5191,5192,5192,5192,2015,24,234,24,148,2015,86,24,125,119,118,24,24,234,86,32,32,0,24,8,8,8,8,8,3,2,2,2,6,6,0,2024-01-08 22:14:00,0
5257,5257,5257,5257,2013,24,292,24,144,2013,148,24,133,122,117,24,24,292,148,27,27,0,24,3,3,3,3,3,15,2,2,2,11,11,0,2024-01-08 22:16:00,0
5271,5270,5270,5270,2031,24,264,24,145,2031,119,24,140,127,119,24,24,264,119,28,28,4,24,4,4,4,4,3,24,2,2,2,13,13,1,2024-01-08 22:18:00,0
5237,5238,5238,5238,2019,24,265,24,145,2019,120,24,130,118,118,24,24,265,120,28,28,4,24,4,4,4,4,4,0,2,2,2,12,12,0,2024-01-08 22:20:00,0
5256,5256,5256,5256,2014,22,396,22,148,2014,248,22,132,121,119,22,22,396,248,31,31,4,22,7,7,7,7,6,6,2,2,2,11,11,1,2024-01-08 22:22:00,0
5299,5299,5299,5299,2039,24,291,24,146,2039,145,24,130,121,119,24,24,291,145,28,28,0,24,4,4,4,4,4,6,2,2,2,9,9,0,2024-01-08 22:24:00,0
5250,5249,5249,5249,2014,24,278,24,145,2014,133,24,133,118,118,24,24,278,133,28,28,0,24,4,4,4,4,4,0,2,2,2,15,15,0,2024-01-08 22:26:00,0
5256,5256,5256,5256,2018,24,284,24,148,2018,136,24,134,127,120,24,24,284,136,31,31,4,24,7,7,7,7,7,21,2,2,2,7,7,0,2024-01-08 22:28:00,0
5194,5193,5193,5193,2012,24,255,24,144,2012,111,24,124,120,118,24,24,255,111,28,28,0,24,4,4,4,4,4,6,2,2,2,4,4,0,2024-01-08 22:30:00,0
5217,5218,5218,5218,2014,24,252,24,143,2014,109,24,128,122,119,24,24,252,109,27,27,2,24,3,3,3,3,3,9,2,2,2,6,6,0,2024-01-08 22:32:00,0
5232,5232,5232,5232,2020,24,259,24,145,2020,114,24,130,120,119,24,24,259,114,28,28,0,24,4,4,4,4,3,3,2,2,2,10,10,1,2024-01-08 22:34:00,0
5233,5234,5234,5234,2016,24,263,24,148,2016,115,24,133,122,119,24,24,263,115,31,31,0,24,7,7,7,7,7,9,2,2,2,11,11,0,2024-01-08 22:36:00,0
5207,5207,5207,5207,2018,24,240,24,145,2018,95,24,125,122,119,24,24,240,95,28,28,4,24,4,4,4,4,3,9,2,2,2,3,3,1,2024-01-08 22:38:00,0
5272,5272,5272,5272,2018,24,296,24,145,2018,151,24,135,121,119,24,24,296,151,28,28,0,24,4,4,4,4,4,6,2,2,2,14,14,0,2024-01-08 22:40:00,0
5263,5262,5262,5262,2014,24,400,24,147,2014,253,24,135,125,118,24,24,400,253,31,31,2,24,7,7,7,7,7,21,2,2,2,10,10,0,2024-01-08 22:42:00,0
5249,5250,5250,5250,2017,24,278,24,145,2017,133,24,132,122,119,24,24,278,133,28,28,0,24,4,4,4,4,4,9,2,2,2,10,10,0,2024-01-08 22:44:00,0
5250,5251,5250,5250,2024,24,272,24,145,2024,127,24,127,122,118,24,24,272,127,28,28,0,24,4,4,4,4,4,12,2,2,2,5,5,0,2024-01-08 22:46:00,0
5257,5256,5256,5256,2029,22,265,22,145,2029,120,22,134,123,119,22,22,265,120,28,28,4,22,4,4,4,4,3,12,2,2,2,11,11,1,2024-01-08 22:48:00,0
5187,5187,5187,5187,2016,24,230,24,148,2016,82,24,123,120,118,24,24,230,82,31,31,0,24,7,7,7,7,7,6,2,2,2,3,3,0,2024-01-08 22:50:00,0
5248,5249,5248,5248,2022,24,377,24,145,2022,232,24,125,120,118,24,24,377,232,28,28,0,24,4,4,4,4,4,6,2,2,2,5,5,0,2024-01-08 22:52:00,0
5186,5186,5186,5186,2002,24,255,24,143,2002,112,24,128,121,117,24,24,255,112,27,27,2,24,4,4,4,4,4,12,2,2,2,7,7,0,2024-01-08 22:54:00,0
5237,5238,5238,5238,2026,24,247,24,144,2026,103,24,130,122,118,24,24,247,103,27,27,0,24,3,3,3,3,3,12,2,2,2,8,8,0,2024-01-08 22:56:00,0
5253,5252,5252,5252,2024,24,372,24,149,2024,223,24,133,124,120,24,24,372,223,32,32,4,24,8,8,8,8,8,12,2,2,2,9,9,0,2024-01-08 22:58:00,0
5229,5230,5230,5230,2027,24,248,24,144,2027,104,24,125,119,118,24,24,248,104,27,27,0,24,3,3,3,3,3,3,2,2,2,6,6,0,2024-01-08 23:00:00,0
5202,5201,5201,5201,2005,24,457,24,144,2005,313,24,127,121,119,24,24,457,313,28,28,0,24,4,4,4,4,3,6,2,2,2,6,6,1,2024-01-08 23:02:00,0
5233,5234,5234,5234,2024,24,355,24,148,2024,207,24,131,121,118,24,24,355,207,31,31,2,24,7,7,7,7,7,9,2,2,2,10,10,0,2024-01-08 23:04:00,0
5262,5262,5262,5262,2026,24,270,24,145,2026,125,24,134,120,118,24,24,270,125,28,28,0,24,4,4,4,4,3,6,2,2,2,14,14,1,2024-01-08 23:06:00,0
5247,5247,5247,5247,2030,24,255,24,146,2030,109,24,130,121,119,24,24,255,109,28,28,1,24,4,4,4,4,4,6,2,2,2,9,9,0,2024-01-08 23:08:00,0
5211,5211,5211,5211,2017,24,242,24,144,2017,98,24,131,122,120,24,24,242,98,28,28,1,24,4,4,4,4,4,6,2,2,2,9,9,0,2024-01-08 23:10:00,0
5227,5225,5225,5225,2019,22,259,22,148,2019,111,22,126,122,118,22,22,259,111,31,31,0,22,7,7,7,7,7,12,2,2,2,4,4,0,2024-01-08 23:12:00,0
5250,5252,5252,5252,2032,24,260,24,146,2032,114,24,126,120,119,24,24,260,114,28,28,4,24,4,4,4,4,4,3,2,2,2,6,6,0,2024-01-08 23:14:00,0
5243,5242,5242,5242,2026,24,256,24,145,2026,111,24,131,122,120,24,24,256,111,28,28,0,24,4,4,4,4,3,6,2,2,2,9,9,1,2024-01-08 23:16:00,0
5194,5194,5194,5194,2001,24,359,24,143,2001,216,24,131,122,118,24,24,359,216,27,27,0,24,3,3,3,3,3,12,2,2,2,9,9,0,2024-01-08 23:18:00,0
5261,5262,5262,5262,2023,24,378,24,148,2023,230,24,133,123,119,24,24,378,230,31,31,7,24,7,7,7,7,7,12,2,2,2,10,10,0,2024-01-08 23:20:00,0
5250,5249,5249,5249,2010,24,291,24,145,2010,146,24,136,122,118,24,24,291,146,28,28,0,24,4,4,4,4,3,12,2,2,2,14,14,1,2024-01-08 23:22:00,0
5233,5234,5234,5234,2013,24,270,24,144,2013,126,24,129,121,119,24,24,270,126,28,28,4,24,4,4,4,4,4,6,2,2,2,8,8,0,2024-01-08 23:24:00,0
5244,5244,5244,5244,2024,24,266,24,148,2024,118,24,128,119,118,24,24,266,118,31,31,0,24,7,7,7,7,7,3,2,2,2,9,9,0,2024-01-08 23:26:00,0
5250,5250,5250,5250,2020,24,377,24,145,2020,232,24,131,124,119,24,24,377,232,28,28,0,24,4,4,4,4,4,15,2,2,2,7,7,0,2024-01-08 23:28:00,0
5300,5300,5300,5300,2024,24,316,24,145,2024,171,24,135,124,118,24,24,316,171,28,28,4,24,4,4,4,4,4,18,2,2,2,11,11,0,2024-01-08 23:30:00,0
5235,5235,5235,5235,2014,24,272,24,144,2014,128,24,129,122,118,24,24,272,128,28,28,0,24,4,4,4,4,3,12,2,2,2,7,7,1,2024-01-08 23:32:00,0
5270,5269,5269,5269,2022,24,292,24,148,2022,144,24,130,121,119,24,24,292,144,31,31,4,24,7,7,7,7,7,6,2,2,2,9,9,0,2024-01-08 23:34:00,0
5266,5267,5267,5267,2030,24,273,24,145,2030,128,24,131,122,119,24,24,273,128,27,27,0,24,3,3,3,3,3,9,2,2,2,9,9,0,2024-01-08 23:36:00,0
5227,5227,5227,5227,2028,22,236,22,145,2028,91,22,126,119,118,22,22,236,91,28,28,0,22,4,4,4,4,3,3,2,2,2,7,7,1,2024-01-08 23:38:00,0
5205,5205,5205,5205,2009,24,261,24,144,2009,117,24,129,120,117,24,24,261,117,28,28,2,24,4,4,4,4,4,9,2,2,2,9,9,0,2024-01-08 23:40:00,0
5216,5215,5215,5215,2022,24,242,24,149,2022,93,24,131,121,119,24,24,242,93,31,31,0,24,7,7,7,7,7,6,2,2,2,10,10,0,2024-01-08 23:42:00,0
5249,5249,5249,5249,2027,24,255,24,145,2027,110,24,134,121,119,24,24,255,110,28,28,0,24,4,4,4,4,4,6,2,2,2,13,13,0,2024-01-08 23:44:00,0
5259,5259,5259,5259,2023,24,273,24,145,2023,128,24,138,121,119,24,24,273,128,28,28,4,24,4,4,4,4,4,6,2,2,2,17,17,0,2024-01-08 23:46:00,0
5248,5247,5247,5247,2017,24,278,24,147,2017,131,24,130,122,117,24,24,278,131,31,31,0,24,7,7,7,7,6,15,2,2,2,8,8,1,2024-01-08 23:48:00,0
5247,5249,5249,5249,2029,24,257,24,146,2029,111,24,127,121,119,24,24,257,111,28,28,4,24,4,4,4,4,4,6,2,2,2,6,6,0,2024-01-08 23:50:00,0
5254,5254,5254,5254,2032,24,258,24,145,2032,113,24,130,120,118,24,24,258,113,28,28,0,24,4,4,4,4,4,6,2,2,2,10,10,0,2024-01-08 23:52:00,0
5239,5238,5238,5238,2022,24,261,24,145,2022,116,24,131,119,119,24,24,261,116,28,28,0,24,4,4,4,4,4,0,2,2,2,12,12,0,2024-01-08 23:54:00,0
5215,5216,5216,5216,2018,24,240,24,148,2018,92,24,134,123,119,24,24,240,92,31,31,2,24,7,7,7,7,7,12,2,2,2,11,11,0,2024-01-08 23:56:00,0
5277,5277,5277,5277,2018,24,296,24,145,2018,151,24,137,121,118,24,24,296,151,28,28,0,24,4,4,4,4,4,9,2,2,2,16,16,0,2024-01-08 23:58:00,0
5280,5280,5280,5280,2034,24,283,24,146,2034,137,24,128,121,118,24,24,283,137,28,28,2,24,4,4,4,4,3,9,2,2,2,7,7,1,2024-01-09 00:00:00,0
5195,5213,5194,5194,1997,22,471,22,147,1997,324,22,133,120,118,22,22,471,324,31,31,0,22,7,7,7,7,7,6,2,2,2,13,13,0,2024-01-09 00:02:00,0
5239,5240,5239,5239,2022,24,361,24,145,2022,216,24,125,120,118,24,24,361,216,28,28,0,24,4,4,4,4,4,6,2,2,2,5,5,0,2024-01-09 00:04:00,0
5220,5221,5221,5221,2021,24,250,24,143,2021,107,24,129,122,120,24,24,250,107,27,27,1,24,3,3,3,3,3,6,2,2,2,7,7,0,2024-01-09 00:06:00,0
5237,5237,5237,5237,2020,24,362,24,145,2020,217,24,128,121,119,24,24,362,217,28,28,0,24,4,4,4,4,4,6,2,2,2,7,7,0,2024-01-09 00:08:00,0
5280,5280,5280,5280,2035,24,278,24,149,2035,129,24,132,125,119,24,24,278,129,31,31,1,24,7,7,7,7,7,18,2,2,2,7,7,0,2024-01-09 00:10:00,0
5250,5249,5249,5249,2023,24,272,24,145,2023,127,24,125,120,119,24,24,272,127,28,28,1,24,4,4,4,4,3,3,2,2,2,5,5,1,2024-01-09 00:12:00,0
5255,5256,5256,5256,2020,24,284,24,144,2020,140,24,128,121,118,24,24,284,140,28,28,0,24,4,4,4,4,4,9,2,2,2,7,7,0,2024-01-09 00:14:00,0
5248,5245,5245,5245,2020,24,268,24,145,2020,123,24,129,119,119,24,24,268,123,28,28,4,24,4,4,4,4,3,0,2,2,2,10,10,1,2024-01-09 00:16:00,0
5268,5269,5269,5269,2030,24,376,24,149,2030,227,24,132,123,119,24,24,376,227,31,31,0,24,7,7,7,7,7,12,2,2,2,9,9,0,2024-01-09 00:18:00,0
5230,5231,5231,5231,2015,24,266,24,145,2015,121,24,128,123,118,24,24,266,121,28,28,0,24,4,4,4,4,4,15,2,2,2,5,5,0,2024-01-09 00:20:00,0
5226,5226,5225,5225,1999,24,388,24,143,1999,245,24,135,121,117,24,24,388,245,27,27,2,24,3,3,3,3,3,12,2,2,2,14,14,0,2024-01-09 00:22:00,0
5260,5261,5261,5261,2020,24,287,24,149,2020,138,24,132,121,119,24,24,287,138,32,32,0,24,8,8,8,8,8,6,2,2,2,11,11,0,2024-01-09 00:24:00,0
5276,5276,5276,5276,2030,22,277,22,144,2030,133,22,134,121,118,22,22,277,133,27,27,4,22,3,3,3,3,3,9,2,2,2,13,13,0,2024-01-09 00:26:00,0
5279,5280,5280,5280,2022,24,292,24,145,2022,147,24,140,124,119,24,24,292,147,28,28,0,24,4,4,4,4,3,15,2,2,2,16,16,1,2024-01-09 00:28:00,0
5241,5241,5241,5241,2029,24,246,24,145,2029,101,24,134,120,119,24,24,246,101,28,28,0,24,4,4,4,4,4,3,2,2,2,14,14,0,2024-01-09 00:30:00,0
5237,5237,5237,5237,2019,24,265,24,148,2019,117,24,131,121,119,24,24,265,117,31,31,0,24,7,7,7,7,6,6,2,2,2,10,10,1,2024-01-09 00:32:00,0
5256,5254,5254,5254,2026,24,275,24,145,2026,130,24,128,123,119,24,24,275,130,28,28,1,24,4,4,4,4,4,12,2,2,2,5,5,0,2024-01-09 00:34:00,0
5265,5267,5267,5267,2031,24,271,24,146,2031,125,24,131,121,119,24,24,271,125,28,28,4,24,4,4,4,4,4,6,2,2,2,10,10,0,2024-01-09 00:36:00,0
5237,5237,5237,5237,2023,24,261,24,145,2023,116,24,126,118,118,24,24,261,116,28,28,0,24,4,4,4,4,3,0,2,2,2,8,8,1,2024-01-09 00:38:00,0
5282,5282,5282,5282,2036,24,280,24,149,2036,131,24,132,123,119,24,24,280,131,31,31,0,24,7,7,7,7,7,12,2,2,2,9,9,0,2024-01-09 00:40:00,0
5232,5232,5232,5232,2020,24,258,24,144,2020,114,24,130,123,118,24,24,258,114,27,27,2,24,3,3,3,3,3,15,2,2,2,7,7,0,2024-01-09 00:42:00,0
5250,5250,5250,5250,2027,24,268,24,145,2027,123,24,127,120,118,24,24,268,123,28,28,0,24,4,4,4,4,3,6,2,2,2,7,7,1,2024-01-09 00:44:00,0
5207,5207,5207,5207,2009,24,268,24,148,2009,120,24,128,120,117,24,24,268,120,32,32,3,24,8,8,8,8,8,9,2,2,2,8,8,0,2024-01-09 00:46:00,0
5272,5292,5272,5272,2035,24,368,24,145,2035,223,24,130,121,119,24,24,368,223,27,27,0,24,3,3,3,3,3,6,2,2,2,9,9,0,2024-01-09 00:48:00,0
5286,5286,5286,5286,2028,24,296,24,145,2028,151,24,135,121,118,24,24,296,151,28,28,0,24,4,4,4,4,3,9,2,2,2,14,14,1,2024-01-09 00:50:00,0
5251,5251,5251,5251,2035,24,302,24,147,2035,155,24,128,119,119,24,24,302,104,29,29,4,24,5,5,4,4,4,0,2,2,2,9,9,0,2024-01-09 00:52:00,52
5242,5242,5242,5242,2026,23,266,23,148,2026,118,23,130,121,118,23,23,266,118,31,31,0,23,7,7,7,7,6,9,2,2,2,9,9,1,2024-01-09 00:54:00,0
5239,5238,5238,5238,2023,23,261,23,145,2023,116,23,130,122,118,23,23,261,116,28,28,0,23,4,4,4,4,4,12,2,2,2,8,8,0,2024-01-09 00:56:00,0
5273,5274,5274,5274,2034,24,278,24,146,2034,132,24,131,119,119,24,24,278,132,28,28,4,24,4,4,4,4,3,0,2,2,2,12,12,1,2024-01-09 00:58:00,0
5222,5222,5222,5222,2028,24,243,24,148,2028,95,24,124,119,118,24,24,243,95,31,31,0,24,7,7,7,7,7,3,2,2,2,5,5,0,2024-01-09 01:00:00,0
5259,5259,5259,5259,2003,24,414,24,144,2003,270,24,137,120,118,24,24,414,270,28,28,0,24,4,4,4,4,4,6,2,2,2,17,17,0,2024-01-09 01:02:00,0
5247,5247,5247,5247,2024,24,267,24,144,2024,123,24,133,122,120,24,24,267,123,27,27,0,24,3,3,3,3,3,6,2,2,2,11,11,0,2024-01-09 01:04:00,0
5239,5239,5239,5239,2026,24,259,24,145,2026,114,24,125,119,118,24,24,259,114,28,28,0,24,4,4,4,4,4,3,2,2,2,6,6,0,2024-01-09 01:06:00,0
5167,5165,5165,5165,1992,24,365,24,146,1992,219,24,125,119,117,24,24,365,219,31,31,5,24,7,7,7,7,7,6,2,2,2,6,6,0,2024-01-09 01:08:00,0
5250,5251,5251,5251,2020,24,276,24,145,2020,131,24,131,120,118,24,24,276,131,28,28,0,24,4,4,4,4,3,6,2,2,2,11,11,1,2024-01-09 01:10:00,0
5254,5255,5255,5255,2027,24,366,24,146,2027,220,24,132,122,118,24,24,366,220,28,28,2,24,4,4,4,4,4,12,2,2,2,10,10,0,2024-01-09 01:12:00,0
5226,5226,5226,5226,2019,24,258,24,144,2019,114,24,130,119,118,24,24,258,114,28,28,0,24,4,4,4,4,3,3,2,2,2,11,11,1,2024-01-09 01:14:00,0
5228,5228,5228,5228,2020,24,254,24,148,2020,106,24,134,121,119,24,24,254,106,31,31,0,24,7,7,7,7,7,6,2,2,2,13,13,0,2024-01-09 01:16:00,0
5243,5242,5242,5242,2014,24,378,23,145,2014,233,23,131,121,118,23,23,378,233,28,28,2,23,4,4,4,4,4,9,2,2,2,10,10,0,2024-01-09 01:18:00,0
5229,5229,5229,5229,2018,22,258,23,143,2018,115,23,132,120,118,23,23,258,115,27,27,0,23,3,3,3,3,3,6,2,2,2,12,12,0,2024-01-09 01:20:00,0
5235,5236,5236,5236,2004,24,292,24,149,2004,143,24,130,122,118,24,24,292,143,32,32,2,24,8,8,8,8,8,12,2,2,2,8,8,0,2024-01-09 01:22:00,0
5275,5275,5275,5275,2026,24,291,24,144,2026,147,24,130,120,119,24,24,291,147,27,27,0,24,3,3,3,3,3,3,2,2,2,10,10,0,2024-01-09 01:24:00,0
5227,5227,5227,5227,2008,24,280,24,144,2008,136,24,128,119,118,24,24,280,136,28,28,0,24,4,4,4,4,3,3,2,2,2,9,9,1,2024-01-09 01:26:00,0
5241,5240,5240,5240,2023,24,256,24,145,2023,111,24,133,123,119,24,24,256,111,28,28,2,24,4,4,4,4,4,12,2,2,2,10,10,0,2024-01-09 01:28:00,0
5273,5274,5274,5274,2027,24,284,24,148,2027,136,24,133,124,119,24,24,284,136,31,31,0,24,7,7,7,7,6,15,2,2,2,9,9,1,2024-01-09 01:30:00,0
5202,5202,5202,5202,2003,24,274,24,143,2003,131,24,126,120,117,24,24,274,131,27,27,0,24,4,4,4,4,4,9,2,2,2,6,6,0,2024-01-09 01:32:00,0
5226,5226,5226,5226,2017,24,256,24,145,2017,111,24,128,122,119,24,24,256,111,28,28,4,24,4,4,4,4,4,9,2,2,2,6,6,0,2024-01-09 01:34:00,0
5295,5295,5295,5295,2024,24,313,24,144,2024,169,24,129,121,118,24,24,313,169,27,27,0,24,3,3,3,3,3,9,2,2,2,8,8,0,2024-01-09 01:36:00,0
5249,5248,5248,5248,2015,24,282,24,148,2015,134,24,134,123,118,24,24,282,134,32,32,4,24,8,8,8,8,8,15,2,2,2,11,11,0,2024-01-09 01:38:00,0
5237,5238,5238,5238,2026,24,256,24,144,2026,112,24,129,121,118,24,24,256,112,27,27,0,24,3,3,3,3,3,9,2,2,2,8,8,0,2024-01-09 01:40:00,0
5260,5260,5260,5260,2027,24,378,24,146,2027,232,24,128,121,118,24,24,378,232,28,28,0,24,4,4,4,4,3,9,2,2,2,7,7,1,2024-01-09 01:42:00,0
5221,5221,5221,5221,2018,23,254,23,147,2018,107,23,131,121,119,23,23,254,107,31,31,4,23,7,7,7,7,7,6,2,2,2,10,10,0,2024-01-09 01:44:00,0
5236,5233,5233,5233,2019,23,259,23,145,2019,114,23,135,122,120,23,23,259,114,28,28,0,23,4,4,4,4,3,6,2,2,2,13,13,1,2024-01-09 01:46:00,0
5240,5243,5243,5243,2016,24,275,24,145,2016,130,24,134,121,119,24,24,275,130,28,28,4,24,4,4,4,4,4,6,2,2,2,13,13,0,2024-01-09 01:48:00,0
5253,5251,5251,5251,2018,24,285,24,145,2018,140,24,128,121,119,24,24,285,140,29,29,0,24,4,4,4,4,4,6,2,2,2,7,7,0,2024-01-09 01:50:00,0
5268,5270,5270,5270,2034,24,323,24,150,2034,173,24,132,122,120,24,24,323,122,32,32,0,24,8,8,7,7,7,6,2,2,2,10,10,0,2024-01-09 01:52:00,52
5172,5172,5172,5172,2004,24,243,24,142,2004,101,24,125,119,117,24,24,243,101,27,27,2,24,4,4,4,4,4,6,2,2,2,6,6,0,2024-01-09 01:54:00,0
5234,5233,5233,5233,2015,24,273,24,144,2015,129,24,127,119,118,24,24,273,129,27,27,0,24,3,3,3,3,3,3,2,2,2,8,8,0,2024-01-09 01:56:00,0
5277,5278,5278,5278,2036,24,369,24,146,2036,223,24,136,122,119,24,24,369,223,28,28,4,24,4,4,4,4,4,9,2,2,2,14,14,0,2024-01-09 01:58:00,0
5282,5280,5280,5280,2037,24,275,24,148,2037,127,24,130,125,119,24,24,275,127,31,31,0,24,7,7,7,7,7,18,2,2,2,5,5,0,2024-01-09 02:00:00,0
5223,5225,5225,5225,2013,24,473,24,145,2013,328,24,122,118,118,24,24,473,328,28,28,0,24,4,4,4,4,3,0,2,2,2,4,4,1,2024-01-09 02:02:00,0
5213,5209,5209,5209,2026,24,231,24,145,2026,86,24,128,122,119,24,24,231,86,28,28,2,24,4,4,4,4,4,9,2,2,2,6,6,0,2024-01-09 02:04:00,0
5255,5259,5259,5259,2023,24,284,24,148,2023,136,24,128,122,119,24,24,284,136,31,31,0,24,7,7,7,7,6,9,2,2,2,6,6,1,2024-01-09 02:06:00,0
5237,5237,5237,5237,2019,24,275,24,145,2019,130,24,124,119,118,24,24,275,130,28,28,5,24,4,4,4,4,4,3,2,2,2,5,5,0,2024-01-09 02:08:00,0
5236,5235,5235,5235,2016,22,268,22,145,2016,123,22,129,122,119,22,22,268,123,28,28,8,22,4,4,4,4,4,9,2,2,2,7,7,0,2024-01-09 02:10:00,0
5245,5245,5245,5245,2029,24,258,24,144,2029,114,24,126,122,119,24,24,258,114,27,27,0,24,3,3,3,3,3,9,2,2,2,4,4,0,2024-01-09 02:12:00,0
5236,5237,5237,5237,2022,24,259,24,149,2022,110,24,132,124,118,24,24,259,110,32,32,4,24,8,8,8,8,8,18,2,2,2,8,8,0,2024-01-09 02:14:00,0
5249,5248,5248,5248,2016,24,284,24,144,2016,140,24,129,119,118,24,24,284,140,27,27,0,24,3,3,3,3,3,3,2,2,2,10,10,0,2024-01-09 02:16:00,0
5239,5240,5240,5240,2016,24,380,24,144,2016,236,24,129,121,118,24,24,380,236,28,28,0,24,4,4,4,4,3,9,2,2,2,8,8,1,2024-01-09 02:18:00,0
5302,5302,5302,5302,2036,24,299,24,149,2036,150,24,131,120,118,24,24,299,150,31,31,2,24,7,7,7,7,7,6,2,2,2,11,11,0,2024-01-09 02:20:00,0
5265,5265,5265,5265,2012,24,405,24,145,2012,260,24,136,123,119,24,24,405,260,28,28,0,24,4,4,4,4,3,12,2,2,2,13,13,1,2024-01-09 02:22:00,0
5234,5233,5233,5233,2018,24,262,24,145,2018,117,24,128,121,118,24,24,262,117,28,28,4,24,4,4,4,4,4,9,2,2,2,7,7,0,2024-01-09 02:24:00,0
5253,5254,5254,5254,2028,24,270,24,145,2028,125,24,127,119,119,24,24,270,125,28,28,0,24,4,4,4,4,4,0,2,2,2,8,8,0,2024-01-09 02:26:00,0
5253,5253,5253,5253,2033,24,260,24,148,2033,112,24,131,122,120,24,24,260,112,31,31,0,24,7,7,7,7,7,6,2,2,2,9,9,0,2024-01-09 02:28:00,0
5262,5261,5261,5261,2025,24,277,24,146,2025,131,24,129,124,119,24,24,277,131,28,28,4,24,4,4,4,4,4,15,2,2,2,5,5,0,2024-01-09 02:30:00,0
5225,5226,5226,5226,2018,24,263,24,143,2018,120,24,128,119,118,24,24,263,120,27,27,0,24,3,3,3,3,3,3,2,2,2,9,9,0,2024-01-09 02:32:00,0
5264,5264,5264,5264,2022,24,282,24,145,2022,137,24,132,123,120,24,24,282,137,28,28,0,24,4,4,4,4,3,9,2,2,2,9,9,1,2024-01-09 02:34:00,0
5257,5257,5257,5257,2036,23,255,23,149,2036,106,23,133,123,119,23,23,255,106,31,31,2,23,7,7,7,7,7,12,2,2,2,10,10,0,2024-01-09 02:36:00,0
5245,5243,5243,5243,2024,23,265,23,145,2024,120,23,126,119,118,23,23,265,120,28,28,0,23,4,4,4,4,3,3,2,2,2,7,7,1,2024-01-09 02:38:00,0
5257,5258,5258,5258,2026,24,269,24,146,2026,123,24,132,124,121,24,24,269,123,28,28,4,24,4,4,4,4,4,9,2,2,2,8,8,0,2024-01-09 02:40:00,0
5216,5216,5216,5216,1997,24,391,24,146,1997,245,24,136,123,118,24,24,391,245,31,31,0,24,7,7,7,7,7,15,2,2,2,13,13,0,2024-01-09 02:42:00,0
5249,5249,5249,5249,2021,24,269,24,145,2021,124,24,133,121,118,24,24,269,124,28,28,0,24,4,4,4,4,4,9,2,2,2,12,12,0,2024-01-09 02:44:00,0
5236,5237,5237,5237,2023,24,259,24,145,2023,114,24,131,122,119,24,24,259,114,28,28,0,24,4,4,4,4,4,9,2,2,2,9,9,0,2024-01-09 02:46:00,0
5240,5240,5240,5240,2012,24,282,24,145,2012,137,24,125,120,118,24,24,282,137,28,28,0,24,4,4,4,4,3,6,2,2,2,5,5,1,2024-01-09 02:48:00,0
5234,5234,5234,5234,2030,24,246,24,148,2030,98,24,131,123,119,24,24,246,98,31,31,1,24,7,7,7,7,7,12,2,2,2,8,8,0,2024-01-09 02:50:00,0
5268,5268,5268,5268,2029,24,270,24,146,2029,124,24,136,124,120,24,24,270,124,28,28,0,24,4,4,4,4,4,12,2,2,2,12,12,0,2024-01-09 02:52:00,0
5236,5236,5236,5236,2015,24,271,24,144,2015,127,24,129,123,118,24,24,271,127,28,28,0,24,4,4,4,4,4,15,2,2,2,6,6,0,2024-01-09 02:54:00,0
5226,5225,5225,5225,2014,24,264,24,144,2014,120,24,124,120,118,24,24,264,120,27,27,2,24,3,3,3,3,3,6,2,2,2,4,4,0,2024-01-09 02:56:00,0
5262,5263,5263,5263,2028,24,281,24,149,2028,132,24,127,121,118,24,24,281,132,32,32,0,24,8,8,8,8,8,9,2,2,2,6,6,0,2024-01-09 02:58:00,0
5237,5236,5236,5236,2015,24,274,24,144,2015,130,24,132,122,118,24,24,274,130,27,27,4,24,3,3,3,3,3,12,2,2,2,10,10,0,2024-01-09 03:00:00,0
5175,5176,5176,5176,1983,22,384,22,143,1983,241,22,128,120,117,22,22,384,241,28,28,0,22,4,4,4,4,3,9,2,2,2,8,8,1,2024-01-09 03:02:00,0
5251,5251,5251,5251,2015,24,294,24,148,2015,146,24,127,120,118,24,24,294,146,31,31,0,24,7,7,7,7,7,6,2,2,2,7,7,0,2024-01-09 03:04:00,0
5254,5254,5254,5254,2033,24,261,24,145,2033,116,24,132,120,119,24,24,261,116,28,28,2,24,4,4,4,4,3,3,2,2,2,12,12,1,2024-01-09 03:06:00,0
5256,5257,5256,5256,2037,24,251,24,146,2037,105,24,128,123,119,24,24,251,105,28,28,0,24,4,4,4,4,4,12,2,2,2,5,5,0,2024-01-09 03:08:00,0
5284,5283,5283,5283,2034,24,278,24,145,2034,133,24,138,126,121,24,24,278,133,28,28,0,24,4,4,4,4,4,15,2,2,2,12,12,0,2024-01-09 03:10:00,0
5256,5257,5257,5257,2033,24,272,24,149,2033,123,24,122,119,118,24,24,272,123,31,31,0,24,7,7,7,7,7,3,2,2,2,3,3,0,2024-01-09 03:12:00,0
5224,5223,5223,5223,2016,24,249,24,145,2016,104,24,135,121,118,24,24,249,104,28,28,0,24,4,4,4,4,4,9,2,2,2,14,14,0,2024-01-09 03:14:00,0
5199,5200,5200,5200,2011,24,244,24,144,2011,100,24,129,120,118,24,24,244,100,28,28,5,24,4,4,4,4,3,6,2,2,2,9,9,1,2024-01-09 03:16:00,0
5216,5215,5216,5216,2021,24,242,24,144,2021,98,24,130,120,119,24,24,242,98,27,27,2,24,3,3,3,3,3,3,2,2,2,10,10,0,2024-01-09 03:18:00,0
5229,5230,5229,5229,2027,24,255,24,148,2027,107,24,124,120,119,24,24,255,107,31,31,0,24,7,7,7,7,7,3,2,2,2,4,4,0,2024-01-09 03:20:00,0
5245,5243,5243,5243,2014,24,290,24,145,2014,145,24,130,122,118,24,24,290,145,28,28,4,24,4,4,4,4,3,12,2,2,2,8,8,1,2024-01-09 03:22:00,0
5200,5201,5201,5201,2005,24,265,24,144,2005,121,24,129,118,117,24,24,265,121,28,28,0,24,4,4,4,4,4,3,2,2,2,11,11,0,2024-01-09 03:24:00,0
5241,5240,5240,5240,2021,22,274,22,147,2021,127,22,131,121,118,22,22,274,127,31,31,2,22,7,7,7,7,7,9,2,2,2,10,10,0,2024-01-09 03:26:00,0
5262,5264,5264,5264,2027,24,274,24,145,2027,129,24,134,123,119,24,24,274,129,28,28,0,24,4,4,4,4,4,12,2,2,2,11,11,0,2024-01-09 03:28:00,0
5252,5251,5251,5251,2031,24,260,24,146,2031,114,24,129,122,120,24,24,260,114,28,28,0,24,4,4,4,4,4,6,2,2,2,7,7,0,2024-01-09 03:30:00,0
126,127,127,127,49,2,3,2,3,49,0,2,3,3,3,2,2,3,0,0,0,0,2,0,0,0,0,0,0,1,1,1,0,0,0,2024-01-09 03:32:00,0
0,0,0,0,0,0,0,0,0,0,0,0,0,0,0,0,0,0,0,0,0,0,0,0,0,0,0,0,0,0,0,0,0,0,0,2024-01-09 03:34:00,0
1916,1916,1915,1915,728,8,122,8,51,728,71,8,50,45,42,8,8,122,71,9,9,4,8,0,0,0,0,0,9,0,0,0,5,5,0,2024-01-09 03:36:00,0
5238,5239,5239,5239,2006,24,293,24,144,2006,149,24,129,124,119,24,24,293,149,28,28,0,24,4,4,4,4,3,15,2,2,2,5,5,1,2024-01-09 03:38:00,0
5231,5231,5231,5231,2024,24,258,24,149,2024,109,24,127,122,118,24,24,258,109,32,32,0,24,8,8,8,8,8,12,2,2,2,5,5,0,2024-01-09 03:40:00,0
5212,5211,5211,5211,2008,24,262,24,143,2008,119,24,130,123,119,24,24,262,119,27,27,4,24,3,3,3,3,3,12,2,2,2,7,7,0,2024-01-09 03:42:00,0
5263,5263,5263,5263,2025,24,281,24,145,2025,136,24,129,119,119,24,24,281,136,28,28,0,24,4,4,4,4,4,0,2,2,2,10,10,0,2024-01-09 03:44:00,0
5217,5218,5218,5218,2020,24,244,24,145,2020,99,24,127,121,119,24,24,244,99,28,28,0,24,4,4,4,4,4,6,2,2,2,6,6,0,2024-01-09 03:46:00,0
5243,5241,5241,5241,2024,24,267,24,148,2024,119,24,135,122,118,24,24,267,119,31,31,4,24,7,7,7,7,6,12,2,2,2,13,13,1,2024-01-09 03:48:00,0
5243,5245,5245,5245,2022,24,262,24,145,2022,117,24,127,119,118,24,24,262,117,28,28,0,24,4,4,4,4,4,3,2,2,2,8,8,0,2024-01-09 03:50:00,0
5242,5241,5241,5241,2029,24,254,24,145,2029,109,24,131,122,119,24,24,254,109,28,28,0,24,4,4,4,4,4,9,2,2,2,9,9,0,2024-01-09 03:52:00,0
5214,5215,5215,5215,2006,22,272,22,144,2006,128,22,137,123,117,22,22,272,128,28,28,0,22,4,4,4,4,4,18,2,2,2,14,14,0,2024-01-09 03:54:00,0
5251,5251,5251,5251,2030,24,258,24,149,2030,109,24,137,122,119,24,24,258,109,31,31,1,24,7,7,7,7,7,9,2,2,2,15,15,0,2024-01-09 03:56:00,0
5245,5245,5245,5245,2033,24,244,24,146,2033,98,24,134,122,119,24,24,244,98,28,28,0,24,4,4,4,4,4,9,2,2,2,12,12,0,2024-01-09 03:58:00,0
5211,5210,5210,5210,2020,24,227,24,144,2020,83,24,135,121,118,24,24,227,83,28,28,0,24,4,4,4,4,3,9,2,2,2,14,14,1,2024-01-09 04:00:00,0
5228,5228,5228,5228,2007,24,681,24,148,2007,533,24,130,121,119,24,24,681,533,31,31,4,24,7,7,7,7,7,6,2,2,2,9,9,0,2024-01-09 04:02:00,0
5240,5240,5240,5240,2023,24,360,24,144,2023,216,24,127,121,119,24,24,360,216,27,27,0,24,3,3,3,3,3,6,2,2,2,6,6,0,2024-01-09 04:04:00,0
5247,5246,5246,5246,2027,24,266,24,145,2027,121,24,126,121,118,24,24,266,121,28,28,0,24,4,4,4,4,3,9,2,2,2,5,5,1,2024-01-09 04:06:00,0
5247,5249,5249,5249,2022,24,369,24,145,2022,224,24,129,122,120,24,24,369,224,28,28,4,24,4,4,4,4,4,6,2,2,2,7,7,0,2024-01-09 04:08:00,0
5260,5260,5260,5260,2027,24,276,24,148,2027,128,24,129,121,119,24,24,276,128,31,31,0,24,7,7,7,7,7,6,2,2,2,8,8,0,2024-01-09 04:10:00,0
5292,5292,5292,5292,2024,24,302,24,146,2024,156,24,138,120,118,24,24,302,156,28,28,1,24,4,4,4,4,4,6,2,2,2,18,18,0,2024-01-09 04:12:00,0
5203,5203,5203,5203,2019,24,231,24,144,2019,87,24,126,119,118,24,24,231,87,28,28,3,24,4,4,4,4,4,3,2,2,2,7,7,0,2024-01-09 04:14:00,0
5251,5251,5251,5251,2023,24,272,24,145,2023,127,24,127,122,119,24,24,272,127,28,28,0,24,4,4,4,4,3,9,2,2,2,5,5,1,2024-01-09 04:16:00,0
5200,5199,5199,5199,2014,22,246,22,147,2014,99,22,130,120,117,22,22,246,99,30,30,4,22,7,7,7,7,7,9,2,2,2,10,10,0,2024-01-09 04:18:00,0
5273,5274,5274,5274,2022,24,292,24,144,2022,148,24,130,120,119,24,24,292,148,27,27,0,24,3,3,3,3,3,3,2,2,2,10,10,0,2024-01-09 04:20:00,0
5284,5284,5284,5284,2018,24,307,24,145,2018,162,24,136,122,118,24,24,307,162,28,28,0,24,4,4,4,4,3,12,2,2,2,14,14,1,2024-01-09 04:22:00,0
5239,5238,5238,5238,2022,24,260,24,149,2022,111,24,134,118,118,24,24,260,111,32,32,2,24,8,8,8,8,8,0,2,2,2,16,16,0,2024-01-09 04:24:00,0
5233,5234,5234,5234,2027,24,283,24,178,2027,105,24,129,122,118,24,24,283,105,61,61,0,24,3,3,3,3,3,12,2,2,2,7,7,0,2024-01-09 04:26:00,91
5256,5256,5256,5256,2024,24,297,24,172,2024,125,24,133,125,120,24,24,297,125,55,55,1,24,4,4,4,4,4,15,2,2,2,8,8,0,2024-01-09 04:28:00,65
5239,5240,5239,5239,2028,24,249,24,146,2028,103,24,129,121,118,24,24,249,103,28,28,0,24,4,4,4,4,4,9,2,2,2,8,8,0,2024-01-09 04:30:00,0
5284,5284,5284,5284,2036,24,284,24,148,2036,136,24,133,120,119,24,24,284,136,31,31,0,24,7,7,7,7,6,3,2,2,2,13,13,1,2024-01-09 04:32:00,0
5275,5275,5275,5275,2034,24,270,24,146,2034,124,24,132,121,118,24,24,270,124,28,28,4,24,4,4,4,4,4,9,2,2,2,11,11,0,2024-01-09 04:34:00,0
5239,5239,5239,5239,2028,24,253,24,145,2028,108,24,129,124,119,24,24,253,108,28,28,0,24,4,4,4,4,3,15,2,2,2,5,5,1,2024-01-09 04:36:00,0
5231,5230,5230,5230,2019,24,360,24,148,2019,212,24,129,120,119,24,24,360,212,31,31,0,24,7,7,7,7,7,3,2,2,2,9,9,0,2024-01-09 04:38:00,0
5220,5221,5221,5221,2009,24,277,24,144,2009,133,24,133,119,117,24,24,277,133,28,28,0,24,4,4,4,4,4,6,2,2,2,14,14,0,2024-01-09 04:40:00,0
5250,5248,5248,5248,2021,22,374,22,144,2021,230,22,130,120,119,22,22,374,230,27,27,0,22,3,3,3,3,3,3,2,2,2,10,10,0,2024-01-09 04:42:00,0
5261,5263,5263,5263,2024,24,282,24,145,2024,137,24,132,119,119,24,24,282,137,28,28,1,24,4,4,4,4,4,0,2,2,2,13,13,0,2024-01-09 04:44:00,0
5234,5234,5234,5234,2027,24,252,24,149,2027,103,24,128,120,119,24,24,252,103,31,31,0,24,7,7,7,7,7,3,2,2,2,8,8,0,2024-01-09 04:46:00,0
5255,5253,5253,5253,2017,24,287,24,144,2017,143,24,132,121,118,24,24,287,143,28,28,0,24,4,4,4,4,3,9,2,2,2,11,11,1,2024-01-09 04:48:00,0
5255,5257,5257,5257,2036,24,258,24,146,2036,112,24,126,120,119,24,24,258,112,28,28,2,24,4,4,4,4,4,3,2,2,2,6,6,0,2024-01-09 04:50:00,0
5513,5512,5512,5512,2031,62,392,62,172,2031,220,62,175,167,164,62,62,392,220,28,28,0,62,4,4,4,4,4,9,2,2,2,8,8,0,2024-01-09 04:52:00,0
5730,5731,5731,5731,2025,105,335,105,216,2025,119,105,199,191,189,105,105,335,119,31,31,2,105,7,7,7,7,6,6,2,2,2,8,8,1,2024-01-09 04:54:00,0
5719,5719,5719,5719,2028,92,341,92,216,2028,125,92,195,188,184,92,92,341,125,28,28,0,92,4,4,4,4,4,12,2,2,2,7,7,0,2024-01-09 04:56:00,0
5718,5718,5718,5718,2027,95,338,95,214,2027,124,95,203,189,186,95,95,338,124,28,28,0,95,4,4,4,4,3,9,2,2,2,14,14,1,2024-01-09 04:58:00,0
5689,5689,5689,5689,2014,103,348,103,219,2014,129,103,191,182,180,103,103,348,129,31,31,4,103,7,7,7,7,7,6,2,2,2,9,9,0,2024-01-09 05:00:00,0
5713,5712,5712,5712,2010,87,374,87,216,2010,158,87,194,188,184,87,87,374,158,28,28,0,87,4,4,4,4,4,12,2,2,2,6,6,0,2024-01-09 05:02:00,0
5690,5690,5690,5690,2007,94,434,94,210,2007,224,94,209,199,196,94,94,434,224,27,27,4,94,3,3,3,3,3,9,2,2,2,10,10,0,2024-01-09 05:04:00,0
5699,5700,5700,5700,2018,91,343,91,202,2018,141,91,186,181,180,91,91,343,141,28,28,0,91,4,4,4,4,4,3,2,2,2,5,5,0,2024-01-09 05:06:00,0
5691,5690,5690,5690,2023,85,338,85,220,2023,118,85,188,180,179,85,85,338,118,31,31,0,85,7,7,7,7,7,3,2,2,2,8,8,0,2024-01-09 05:08:00,0
5705,5705,5705,5705,2029,100,311,100,212,2029,99,100,200,191,191,100,100,311,99,28,28,4,100,4,4,4,4,3,0,2,2,2,9,9,1,2024-01-09 05:10:00,0
5773,5774,5774,5774,2037,100,468,100,226,2037,242,100,195,184,182,100,100,468,242,28,28,0,100,4,4,4,4,4,6,2,2,2,11,11,0,2024-01-09 05:12:00,0
5703,5700,5700,5700,2029,90,320,90,204,2029,116,90,205,192,188,90,90,320,116,28,28,3,90,4,4,4,4,3,12,2,2,2,13,13,1,2024-01-09 05:14:00,0
5716,5718,5718,5718,2030,101,323,101,222,2030,101,101,190,186,186,101,101,323,101,31,31,1,101,7,7,7,7,7,0,2,2,2,4,4,0,2024-01-09 05:16:00,0
5723,5724,5724,5724,2022,87,328,87,207,2022,121,87,209,194,193,87,87,328,121,28,28,0,87,4,4,4,4,4,3,2,2,2,15,15,0,2024-01-09 05:18:00,0
5704,5703,5703,5703,2029,85,339,85,211,2029,128,85,197,188,185,85,85,339,128,27,27,2,85,3,3,3,3,3,9,2,2,2,9,9,0,2024-01-09 05:20:00,0
5741,5742,5742,5742,2015,94,380,94,234,2015,146,94,202,187,184,94,94,380,146,42,42,0,94,8,8,8,8,8,9,2,2,2,15,15,0,2024-01-09 05:22:00,25
5768,5768,5768,5768,2034,94,428,94,300,2034,128,94,198,186,182,94,94,428,128,106,106,0,94,3,3,3,3,3,12,2,2,2,12,12,0,2024-01-09 05:24:00,190
5683,5682,5682,5682,2021,99,333,99,216,2021,117,99,183,177,176,99,99,333,117,30,30,4,99,4,4,4,4,3,3,2,2,2,6,6,1,2024-01-09 05:26:00,4
5687,5687,5687,5687,2010,89,349,89,217,2010,132,89,194,188,186,89,89,349,132,28,28,0,89,4,4,4,4,4,6,2,2,2,6,6,0,2024-01-09 05:28:00,0
5738,5738,5738,5738,2025,96,353,96,217,2025,136,96,206,195,191,96,96,353,136,31,31,2,96,7,7,7,7,6,12,2,2,2,11,11,1,2024-01-09 05:30:00,0
5741,5740,5740,5740,2029,96,362,96,221,2029,141,96,197,191,188,96,96,362,141,28,28,0,96,4,4,4,4,4,9,2,2,2,6,6,0,2024-01-09 05:32:00,0
5663,5664,5664,5664,2022,95,306,95,206,2022,100,95,193,189,187,95,95,306,100,28,28,0,95,4,4,4,4,4,6,2,2,2,4,4,0,2024-01-09 05:34:00,0
5688,5688,5688,5688,2023,87,354,87,225,2023,129,87,185,179,178,87,87,354,129,31,31,4,87,7,7,7,7,7,3,2,2,2,6,6,0,2024-01-09 05:36:00,0
5751,5751,5751,5751,2030,100,364,100,220,2030,144,100,200,195,192,100,100,364,144,28,28,2,100,4,4,4,4,4,9,2,2,2,5,5,0,2024-01-09 05:38:00,0
5713,5714,5714,5714,2017,96,341,96,211,2017,130,96,195,184,178,96,96,341,130,27,27,4,96,3,3,3,3,3,18,2,2,2,11,11,0,2024-01-09 05:40:00,0
5698,5697,5697,5697,2017,86,324,86,209,2017,115,86,209,201,200,86,86,324,115,28,28,0,86,4,4,4,4,3,3,2,2,2,8,8,1,2024-01-09 05:42:00,0
5713,5714,5714,5714,2031,89,341,89,218,2031,123,89,192,181,179,89,89,341,123,31,31,0,89,7,7,7,7,7,6,2,2,2,11,11,0,2024-01-09 05:44:00,0
5707,5707,5707,5707,2026,91,344,91,213,2026,131,91,196,192,188,91,91,344,131,28,28,2,91,4,4,4,4,3,12,2,2,2,4,4,1,2024-01-09 05:46:00,0
5729,5728,5728,5728,2033,96,313,96,209,2033,104,96,199,190,188,96,96,313,104,28,28,0,96,4,4,4,4,4,6,2,2,2,9,9,0,2024-01-09 05:48:00,0
5689,5688,5688,5688,2030,96,316,96,210,2030,106,96,197,188,186,96,96,316,106,28,28,4,96,4,4,4,4,4,6,2,2,2,9,9,0,2024-01-09 05:50:00,0
5603,5604,5604,5604,2007,91,359,91,206,2007,153,91,201,193,190,91,91,359,102,32,32,0,91,8,8,7,7,7,9,2,2,2,8,8,0,2024-01-09 05:52:00,52
5698,5699,5699,5699,2020,92,334,92,218,2020,116,92,185,172,170,92,92,334,116,28,28,0,92,4,4,4,4,4,6,2,2,2,13,13,0,2024-01-09 05:54:00,0
5705,5705,5705,5705,2028,93,312,93,200,2028,112,93,196,188,183,93,93,312,112,27,27,4,93,3,3,3,3,3,15,2,2,2,8,8,0,2024-01-09 05:56:00,0
5716,5715,5715,5715,2023,82,353,81,224,2023,129,81,196,185,182,81,81,353,129,32,32,0,81,8,8,8,8,8,9,2,2,2,11,11,0,2024-01-09 05:58:00,0
5725,5726,5726,5726,2029,94,323,95,207,2029,116,95,205,198,192,95,95,323,116,27,27,0,95,3,3,3,3,3,18,2,2,2,7,7,0,2024-01-09 06:00:00,0
5696,5695,5695,5695,2012,97,319,97,213,2012,106,97,197,191,189,97,97,319,106,28,28,2,97,4,4,4,4,3,6,2,2,2,6,6,1,2024-01-09 06:02:00,0
5758,5759,5759,5759,2022,86,377,86,220,2022,157,86,216,204,200,86,86,377,157,28,28,0,86,4,4,4,4,4,12,2,2,2,12,12,0,2024-01-09 06:04:00,0
5719,5719,5719,5719,2022,85,359,85,218,2022,141,85,196,187,182,85,85,359,141,31,31,4,85,7,7,7,7,6,15,2,2,2,9,9,1,2024-01-09 06:06:00,0
5657,5656,5656,5656,2013,91,408,91,209,2013,199,91,205,196,193,91,91,408,199,28,28,0,91,4,4,4,4,4,9,2,2,2,9,9,0,2024-01-09 06:08:00,0
5703,5724,5704,5704,2023,97,330,97,220,2023,110,97,207,200,196,97,97,330,110,28,28,0,97,4,4,4,4,4,12,2,2,2,7,7,0,2024-01-09 06:10:00,0
5736,5735,5735,5735,2025,102,341,102,216,2025,125,102,212,199,197,102,102,341,125,27,27,4,102,3,3,3,3,3,6,2,2,2,13,13,0,2024-01-09 06:12:00,0
5644,5644,5644,5644,2006,101,324,101,212,2006,112,101,199,191,186,101,101,324,112,32,32,0,101,8,8,8,8,8,15,2,2,2,8,8,0,2024-01-09 06:14:00,0
5677,5678,5678,5678,2014,93,312,93,212,2014,100,93,203,195,194,93,93,312,100,27,27,2,93,3,3,3,3,3,3,2,2,2,8,8,0,2024-01-09 06:16:00,0
5673,5671,5671,5671,2022,89,329,89,220,2022,109,89,197,195,194,89,89,329,109,28,28,0,89,4,4,4,4,3,3,2,2,2,2,2,1,2024-01-09 06:18:00,0
5733,5734,5734,5734,2032,94,330,94,219,2032,111,94,204,196,191,94,94,330,111,31,31,0,94,7,7,7,7,7,15,2,2,2,8,8,0,2024-01-09 06:20:00,0
5695,5696,5696,5696,2015,85,452,85,221,2015,231,85,205,195,195,85,85,452,231,28,28,2,85,4,4,4,4,3,0,2,2,2,10,10,1,2024-01-09 06:22:00,0
5737,5735,5735,5735,2027,96,352,96,209,2027,143,96,213,200,198,96,96,352,143,28,28,0,96,4,4,4,4,4,6,2,2,2,13,13,0,2024-01-09 06:24:00,0
5719,5720,5720,5720,2037,98,324,98,221,2037,103,98,191,187,183,98,98,324,103,28,28,0,98,4,4,4,4,4,12,2,2,2,4,4,0,2024-01-09 06:26:00,0
5733,5733,5733,5733,2022,96,351,96,209,2022,142,96,205,191,185,96,96,351,142,31,31,0,96,7,7,7,7,7,18,2,2,2,14,14,0,2024-01-09 06:28:00,0
5747,5746,5746,5746,2027,90,376,90,215,2027,161,90,197,188,185,90,90,376,161,28,28,0,90,4,4,4,4,4,9,2,2,2,9,9,0,2024-01-09 06:30:00,0
5730,5731,5731,5731,2026,81,468,81,220,2026,248,81,204,195,190,81,81,468,248,28,28,5,81,4,4,4,4,3,15,2,2,2,9,9,1,2024-01-09 06:32:00,0
5736,5737,5737,5737,2039,92,341,92,220,2039,121,92,201,192,191,92,92,341,121,31,31,0,92,7,7,7,7,7,3,2,2,2,9,9,0,2024-01-09 06:34:00,0
5742,5742,5742,5742,2027,95,341,95,208,2027,133,95,194,189,185,95,95,341,133,27,27,0,95,3,3,3,3,3,12,2,2,2,5,5,0,2024-01-09 06:36:00,0
5676,5676,5676,5676,2013,88,344,88,218,2013,126,88,195,186,185,88,88,344,126,28,28,2,88,4,4,4,4,3,3,2,2,2,9,9,1,2024-01-09 06:38:00,0
5729,5728,5728,5728,2030,93,323,93,221,2030,102,93,205,195,192,93,93,323,102,28,28,0,93,4,4,4,4,4,9,2,2,2,10,10,0,2024-01-09 06:40:00,0
5694,5694,5694,5694,2010,92,348,92,219,2010,129,92,197,187,184,92,92,348,129,31,31,4,92,7,7,7,7,7,9,2,2,2,10,10,0,2024-01-09 06:42:00,0
5690,5690,5690,5690,2021,90,320,90,209,2021,111,90,208,196,191,90,90,320,111,28,28,0,90,4,4,4,4,4,15,2,2,2,12,12,0,2024-01-09 06:44:00,0
5746,5746,5747,5747,2023,86,387,86,226,2023,161,86,194,181,179,86,86,387,161,28,28,0,86,4,4,4,4,4,6,2,2,2,13,13,0,2024-01-09 06:46:00,0
5726,5726,5725,5725,2027,87,341,87,215,2027,126,87,211,202,197,87,87,341,126,28,28,2,87,4,4,4,4,3,15,2,2,2,9,9,1,2024-01-09 06:48:00,0
5703,5704,5704,5704,2028,88,332,88,206,2028,128,88,203,193,192,88,88,332,126,31,31,0,88,7,7,7,7,7,3,2,2,2,10,10,0,2024-01-09 06:50:00,8
5691,5691,5691,5691,2040,88,307,88,214,2040,93,88,189,185,182,88,88,307,93,28,28,0,88,4,4,4,4,4,9,2,2,2,4,4,0,2024-01-09 06:52:00,0
5747,5747,5747,5747,2024,88,347,88,221,2024,126,88,210,202,201,88,88,347,126,28,28,0,88,4,4,4,4,4,3,2,2,2,8,8,0,2024-01-09 06:54:00,0
5680,5678,5678,5678,2023,102,329,102,211,2023,118,102,197,189,187,102,102,329,118,31,31,0,102,7,7,7,7,7,6,2,2,2,8,8,0,2024-01-09 06:56:00,0
5725,5727,5727,5727,2026,98,408,98,207,2026,201,98,203,195,195,98,98,408,201,28,28,5,98,4,4,4,4,4,0,2,2,2,8,8,0,2024-01-09 06:58:00,0
5691,5691,5691,5691,2029,86,322,86,212,2029,110,86,199,193,189,86,86,322,110,27,27,0,86,3,3,3,3,3,12,2,2,2,6,6,0,2024-01-09 07:00:00,0
5618,5617,5617,5617,1984,80,542,80,201,1984,341,80,202,192,191,80,80,542,341,27,27,0,80,4,4,4,4,3,3,2,2,2,10,10,1,2024-01-09 07:02:00,0
5697,5698,5698,5698,2016,88,343,88,205,2016,138,88,200,184,184,88,88,343,138,31,31,4,88,7,7,7,7,7,0,2,2,2,16,16,0,2024-01-09 07:04:00,0
5724,5724,5724,5724,2032,93,335,93,201,2032,134,93,192,181,179,93,93,335,134,28,28,0,93,4,4,4,4,3,6,2,2,2,11,11,1,2024-01-09 07:06:00,0
5731,5731,5731,5731,2026,93,325,93,225,2026,100,93,203,195,190,93,93,325,100,28,28,2,93,4,4,4,4,4,15,2,2,2,8,8,0,2024-01-09 07:08:00,0
5693,5692,5692,5692,2030,84,315,84,207,2030,108,84,188,172,169,84,84,315,108,28,28,0,84,4,4,4,4,4,9,2,2,2,16,16,0,2024-01-09 07:10:00,0
5706,5703,5703,5703,2007,90,401,90,219,2007,182,90,201,186,186,90,90,401,182,31,31,1,90,7,7,7,7,7,0,2,2,2,15,15,0,2024-01-09 07:12:00,0
5658,5660,5660,5660,2004,95,388,95,218,2004,170,95,195,181,181,95,95,388,170,28,28,16,95,4,4,4,4,4,0,2,2,2,14,14,0,2024-01-09 07:14:00,0
5694,5694,5694,5694,2011,86,413,86,205,2011,208,86,195,177,175,86,86,413,208,28,28,11,86,4,4,4,4,3,6,2,2,2,18,18,1,2024-01-09 07:16:00,0
5613,5614,5614,5614,2018,101,327,101,215,2018,112,101,211,201,196,101,101,327,112,27,27,6,101,3,3,3,3,3,15,2,2,2,10,10,0,2024-01-09 07:18:00,0
5678,5678,5678,5678,2032,91,347,91,207,2032,140,91,193,186,180,91,91,347,140,31,31,0,91,7,7,7,7,7,18,2,2,2,7,7,0,2024-01-09 07:20:00,0
5613,5613,5613,5613,2004,87,437,87,205,2004,232,87,197,189,185,87,87,437,232,28,28,0,87,4,4,4,4,3,12,2,2,2,8,8,1,2024-01-09 07:22:00,0
5629,5630,5630,5630,2003,90,343,90,208,2003,135,90,183,176,175,90,90,343,135,28,28,2,90,4,4,4,4,4,3,2,2,2,7,7,0,2024-01-09 07:24:00,0
5707,5707,5707,5707,2024,89,343,89,215,2024,128,89,203,193,187,89,89,343,128,31,31,0,89,7,7,7,7,7,18,2,2,2,10,10,0,2024-01-09 07:26:00,0
5707,5706,5706,5706,2025,88,328,87,216,2025,112,87,200,191,190,87,87,328,112,28,28,0,87,4,4,4,4,4,3,2,2,2,9,9,0,2024-01-09 07:28:00,0
5710,5711,5711,5711,2027,86,348,87,215,2027,133,87,194,184,182,87,87,348,133,28,28,4,87,4,4,4,4,4,6,2,2,2,10,10,0,2024-01-09 07:30:00,0
5753,5753,5753,5753,2026,85,388,85,216,2026,172,85,194,188,186,85,85,388,172,28,28,0,85,4,4,4,4,3,6,2,2,2,6,6,1,2024-01-09 07:32:00,0
5745,5745,5745,5745,2024,100,361,100,223,2024,138,100,196,189,187,100,100,361,138,31,31,4,100,7,7,7,7,7,6,2,2,2,7,7,0,2024-01-09 07:34:00,0
5692,5690,5690,5690,2020,84,340,84,218,2020,122,84,205,193,192,84,84,340,122,27,27,0,84,3,3,3,3,3,3,2,2,2,12,12,0,2024-01-09 07:36:00,0
5743,5744,5744,5744,2029,98,347,98,215,2029,132,98,206,198,196,98,98,347,132,28,28,0,98,4,4,4,4,3,6,2,2,2,8,8,1,2024-01-09 07:38:00,0
5715,5717,5716,5716,2028,93,348,93,209,2028,139,93,201,191,185,93,93,348,139,28,28,2,93,4,4,4,4,4,18,2,2,2,10,10,0,2024-01-09 07:40:00,0
5739,5739,5739,5739,2017,109,360,109,221,2017,139,109,202,192,187,109,109,360,139,31,31,0,109,7,7,7,7,7,15,2,2,2,10,10,0,2024-01-09 07:42:00,0
5706,5706,5706,5706,2019,96,332,96,220,2019,112,96,211,197,195,96,96,332,112,28,28,4,96,4,4,4,4,4,6,2,2,2,14,14,0,2024-01-09 07:44:00,0
5714,5713,5713,5713,2027,95,329,95,216,2027,113,95,185,181,181,95,95,329,113,28,28,0,95,4,4,4,4,4,0,2,2,2,4,4,0,2024-01-09 07:46:00,0
5679,5679,5679,5679,1995,92,344,92,214,1995,130,92,203,194,188,92,92,344,130,31,31,0,92,7,7,7,7,6,18,2,2,2,9,9,1,2024-01-09 07:48:00,0
5728,5728,5728,5728,2032,98,329,98,206,2032,123,98,190,183,182,98,98,329,123,28,28,0,98,4,4,4,4,4,3,2,2,2,7,7,0,2024-01-09 07:50:00,0
5737,5736,5736,5736,2028,96,342,96,212,2028,130,96,209,202,198,96,96,342,130,28,28,0,96,4,4,4,4,4,12,2,2,2,7,7,0,2024-01-09 07:52:00,0
5684,5686,5686,5686,2015,97,339,97,221,2015,118,97,189,179,177,97,97,339,118,28,28,1,97,4,4,4,4,4,6,2,2,2,10,10,0,2024-01-09 07:54:00,0
5707,5706,5706,5706,2020,87,352,87,228,2020,124,87,203,192,188,87,87,352,124,31,31,0,87,7,7,7,7,7,12,2,2,2,11,11,0,2024-01-09 07:56:00,0
5678,5679,5679,5679,2018,87,338,87,210,2018,128,87,199,188,188,87,87,338,128,28,28,0,87,4,4,4,4,4,0,2,2,2,11,11,0,2024-01-09 07:58:00,0
5725,5726,5725,5725,2032,102,338,102,221,2032,117,102,192,186,183,102,102,338,117,28,28,2,102,4,4,4,4,3,9,2,2,2,6,6,1,2024-01-09 08:00:00,0
5693,5693,5693,5693,2005,94,460,94,220,2005,240,94,201,192,189,94,94,460,240,27,27,0,94,3,3,3,3,3,9,2,2,2,9,9,0,2024-01-09 08:02:00,0
5745,5745,5745,5745,2021,81,369,81,221,2021,148,81,208,198,197,81,81,369,148,31,31,0,81,7,7,7,7,7,3,2,2,2,10,10,0,2024-01-09 08:04:00,0
5739,5739,5739,5739,2020,102,347,102,215,2020,132,102,215,206,200,102,102,347,132,28,28,2,102,4,4,4,4,3,18,2,2,2,9,9,1,2024-01-09 08:06:00,0
5729,5729,5729,5729,2026,89,348,89,215,2026,133,89,198,191,186,89,89,348,133,28,28,0,89,4,4,4,4,4,15,2,2,2,7,7,0,2024-01-09 08:08:00,0
5708,5707,5707,5707,2012,92,349,92,213,2012,136,92,204,193,189,92,92,349,136,31,31,0,92,7,7,7,7,7,12,2,2,2,11,11,0,2024-01-09 08:10:00,0
5773,5774,5774,5774,2030,99,361,99,224,2030,137,99,213,204,199,99,99,361,137,28,28,0,99,4,4,4,4,4,15,2,2,2,9,9,0,2024-01-09 08:12:00,0
5700,5700,5700,5700,2019,86,346,86,215,2019,131,86,204,195,192,86,86,346,131,28,28,1,86,4,4,4,4,4,9,2,2,2,9,9,0,2024-01-09 08:14:00,0
5754,5753,5753,5753,2024,98,341,98,214,2024,127,98,200,192,188,98,98,341,127,28,28,0,98,4,4,4,4,3,12,2,2,2,8,8,1,2024-01-09 08:16:00,0
5664,5665,5665,5665,2028,84,300,84,213,2028,87,84,200,190,187,84,84,300,87,31,31,0,84,7,7,7,7,7,9,2,2,2,10,10,0,2024-01-09 08:18:00,0
5750,5748,5748,5748,2035,77,333,77,210,2035,123,77,206,192,187,77,77,333,123,27,27,4,77,3,3,3,3,3,15,2,2,2,14,14,0,2024-01-09 08:20:00,0
5747,5748,5748,5748,2018,96,384,96,210,2018,174,96,198,187,184,96,96,384,174,28,28,0,96,4,4,4,4,3,9,2,2,2,11,11,1,2024-01-09 08:22:00,0
5707,5707,5707,5707,2009,103,369,103,225,2009,144,103,181,177,176,103,103,369,144,28,28,0,103,4,4,4,4,4,3,2,2,2,4,4,0,2024-01-09 08:24:00,0
5680,5681,5681,5681,2021,84,339,84,204,2021,135,84,199,191,187,84,84,339,135,31,31,4,84,7,7,7,7,7,12,2,2,2,8,8,0,2024-01-09 08:26:00,0
5729,5729,5729,5729,2015,99,357,99,207,2015,150,99,201,187,184,99,99,357,150,28,28,0,99,4,4,4,4,4,9,2,2,2,14,14,0,2024-01-09 08:28:00,0
5743,5743,5743,5743,2029,89,333,89,212,2029,121,89,203,196,193,89,89,333,121,28,28,4,89,4,4,4,4,4,9,2,2,2,7,7,0,2024-01-09 08:30:00,0
5696,5696,5696,5696,2018,91,351,91,214,2018,137,91,203,191,186,91,91,351,137,31,31,0,91,7,7,7,7,6,15,2,2,2,12,12,1,2024-01-09 08:32:00,0
5742,5741,5741,5741,2027,94,360,94,212,2027,148,94,185,179,178,94,94,360,148,28,28,0,94,4,4,4,4,4,3,2,2,2,6,6,0,2024-01-09 08:34:00,0
5740,5741,5741,5741,2028,99,338,99,209,2028,129,99,200,187,182,99,99,338,129,27,27,4,99,3,3,3,3,3,15,2,2,2,13,13,0,2024-01-09 08:36:00,0
5708,5708,5708,5708,2026,84,350,84,222,2026,128,84,187,183,182,84,84,350,128,28,28,0,84,4,4,4,4,3,3,2,2,2,4,4,1,2024-01-09 08:38:00,0
5748,5746,5746,5746,2030,92,370,92,222,2030,148,92,190,186,186,92,92,370,148,32,32,3,92,8,8,8,8,8,0,2,2,2,4,4,0,2024-01-09 08:40:00,0
5718,5720,5720,5720,2017,93,350,93,209,2017,141,93,203,192,189,93,93,350,141,27,27,1,93,3,3,3,3,3,9,2,2,2,11,11,0,2024-01-09 08:42:00,0
5708,5708,5708,5708,2029,92,335,92,209,2029,126,92,204,197,194,92,92,335,126,28,28,0,92,4,4,4,4,4,9,2,2,2,7,7,0,2024-01-09 08:44:00,0
5737,5737,5737,5737,2023,81,363,81,221,2023,142,81,199,195,192,81,81,363,142,28,28,2,81,4,4,4,4,4,9,2,2,2,4,4,0,2024-01-09 08:46:00,0
5706,5706,5705,5705,2017,96,345,96,223,2017,122,96,199,193,192,96,96,345,122,31,31,0,96,7,7,7,7,6,3,2,2,2,6,6,1,2024-01-09 08:48:00,0
5713,5714,5714,5714,2024,90,343,90,211,2024,132,90,201,191,190,90,90,343,132,28,28,1,90,4,4,4,4,4,3,2,2,2,10,10,0,2024-01-09 08:50:00,0
5682,5682,5682,5682,2018,87,347,87,218,2018,129,87,209,202,194,87,87,347,129,28,28,2,87,4,4,4,4,4,24,2,2,2,7,7,0,2024-01-09 08:52:00,0
5744,5743,5743,5743,2018,87,378,87,221,2018,157,87,199,185,181,87,87,378,157,31,31,0,87,7,7,7,7,6,12,2,2,2,14,14,1,2024-01-09 08:54:00,0
5667,5667,5667,5667,2007,91,332,91,227,2007,105,91,191,183,181,91,91,332,105,28,28,4,91,4,4,4,4,4,6,2,2,2,8,8,0,2024-01-09 08:56:00,0
5774,5774,5774,5774,2023,90,377,90,210,2023,167,90,196,189,184,90,90,377,167,27,27,0,90,3,3,3,3,3,15,2,2,2,7,7,0,2024-01-09 08:58:00,0
5712,5712,5712,5712,2016,91,330,91,213,2016,117,91,205,195,191,91,91,330,117,28,28,0,91,4,4,4,4,3,12,2,2,2,10,10,1,2024-01-09 09:00:00,0
5690,5689,5689,5689,2015,93,433,93,214,2015,219,93,200,192,187,93,93,433,219,32,32,2,93,8,8,8,8,8,15,2,2,2,8,8,0,2024-01-09 09:02:00,0
5702,5703,5703,5703,2020,105,333,105,210,2020,123,105,199,191,188,105,105,333,123,27,27,0,105,3,3,3,3,3,9,2,2,2,8,8,0,2024-01-09 09:04:00,0
5722,5721,5721,5721,2031,88,337,88,220,2031,117,88,210,200,198,88,88,337,117,28,28,2,88,4,4,4,4,4,6,2,2,2,10,10,0,2024-01-09 09:06:00,0
5723,5724,5724,5724,2028,93,322,93,219,2028,103,93,206,196,195,93,93,322,103,28,28,0,93,4,4,4,4,4,3,2,2,2,10,10,0,2024-01-09 09:08:00,0
5701,5702,5702,5702,2020,86,344,86,215,2020,129,86,197,191,188,86,86,344,129,31,31,0,86,7,7,7,7,6,9,2,2,2,6,6,1,2024-01-09 09:10:00,0
5758,5757,5757,5757,2029,86,462,86,220,2029,242,86,208,196,195,86,86,462,242,28,28,2,86,4,4,4,4,4,3,2,2,2,12,12,0,2024-01-09 09:12:00,0
5713,5714,5714,5714,2029,85,321,85,217,2029,104,85,194,189,188,85,85,321,104,28,28,0,85,4,4,4,4,3,3,2,2,2,5,5,1,2024-01-09 09:14:00,0
5744,5744,5744,5744,2021,95,343,95,220,2021,123,95,207,196,194,95,95,343,123,31,31,0,95,7,7,7,7,7,6,2,2,2,11,11,0,2024-01-09 09:16:00,0
5673,5673,5673,5673,2012,100,310,100,212,2012,98,100,203,201,200,100,100,310,98,28,28,0,100,4,4,4,4,4,3,2,2,2,2,2,0,2024-01-09 09:18:00,0
5734,5734,5734,5734,2028,100,334,100,216,2028,118,100,211,205,203,100,100,334,118,27,27,0,100,3,3,3,3,3,6,2,2,2,6,6,0,2024-01-09 09:20:00,0
5730,5730,5730,5730,2012,98,355,98,213,2012,142,98,205,194,193,98,98,355,142,28,28,5,98,4,4,4,4,4,3,2,2,2,11,11,0,2024-01-09 09:22:00,0
5721,5721,5721,5721,2013,94,373,94,218,2013,155,94,200,183,182,94,94,373,155,31,31,0,94,7,7,7,7,7,3,2,2,2,17,17,0,2024-01-09 09:24:00,0
5765,5765,5765,5765,2022,87,389,87,222,2022,167,87,210,200,194,87,87,389,167,28,28,0,87,4,4,4,4,3,18,2,2,2,10,10,1,2024-01-09 09:26:00,0
5701,5701,5701,5701,2017,100,327,100,208,2017,119,100,197,190,189,100,100,327,119,28,28,4,100,4,4,4,4,4,3,2,2,2,7,7,0,2024-01-09 09:28:00,0
5703,5703,5703,5703,2029,84,335,84,211,2029,124,84,188,184,182,84,84,335,124,31,31,0,84,7,7,7,7,6,6,2,2,2,4,4,1,2024-01-09 09:30:00,0
5722,5722,5722,5722,2017,88,371,88,218,2017,153,88,195,186,184,88,88,371,153,28,28,0,88,4,4,4,4,4,6,2,2,2,9,9,0,2024-01-09 09:32:00,0
5726,5726,5726,5726,2016,89,352,89,213,2016,139,89,193,186,183,89,89,352,139,28,28,0,89,4,4,4,4,4,9,2,2,2,7,7,0,2024-01-09 09:34:00,0
5718,5718,5718,5718,2023,91,338,91,218,2023,120,91,194,186,184,91,91,338,120,27,27,0,91,3,3,3,3,3,6,2,2,2,8,8,0,2024-01-09 09:36:00,0
5685,5683,5683,5683,2020,92,338,92,228,2020,110,92,204,198,197,92,92,338,110,32,32,3,92,8,8,8,8,8,3,2,2,2,6,6,0,2024-01-09 09:38:00,0
5717,5719,5719,5719,2023,94,332,94,212,2023,120,94,200,192,189,94,94,332,120,27,27,0,94,3,3,3,3,3,9,2,2,2,8,8,0,2024-01-09 09:40:00,0
5624,5624,5624,5624,1992,92,315,92,204,1992,111,92,200,189,187,92,92,315,111,27,27,4,92,4,4,4,4,3,6,2,2,2,11,11,1,2024-01-09 09:42:00,0
5721,5721,5721,5721,2022,92,335,92,209,2022,126,92,193,187,184,92,92,335,126,28,28,0,92,4,4,4,4,4,9,2,2,2,6,6,0,2024-01-09 09:44:00,0
5682,5681,5681,5681,2034,83,317,83,220,2034,97,83,191,182,180,83,83,317,97,31,31,0,83,7,7,7,7,6,6,2,2,2,9,9,1,2024-01-09 09:46:00,0
5696,5697,5697,5697,2025,94,318,94,221,2025,97,94,189,183,182,94,94,318,97,28,28,4,94,4,4,4,4,4,3,2,2,2,6,6,0,2024-01-09 09:48:00,0
5726,5726,5726,5726,2025,102,351,102,219,2025,132,102,205,193,190,102,102,351,132,28,28,0,102,4,4,4,4,4,9,2,2,2,12,12,0,2024-01-09 09:50:00,0
5723,5724,5723,5723,2026,95,482,95,205,2026,277,95,196,185,184,95,95,482,226,32,32,0,95,8,8,7,7,7,3,2,2,2,11,11,0,2024-01-09 09:52:00,52
5739,5739,5739,5739,2026,86,357,86,213,2026,144,86,197,191,188,86,86,357,144,28,28,0,86,4,4,4,4,4,9,2,2,2,6,6,0,2024-01-09 09:54:00,0
5732,5732,5732,5732,2023,100,345,100,218,2023,127,100,195,190,185,100,100,345,127,27,27,0,100,3,3,3,3,3,15,2,2,2,5,5,0,2024-01-09 09:56:00,0
5717,5716,5716,5716,2024,100,425,100,216,2024,209,100,188,183,178,100,100,425,209,28,28,5,100,4,4,4,4,4,15,2,2,2,5,5,0,2024-01-09 09:58:00,0
5702,5703,5703,5703,2022,92,323,92,213,2022,110,92,201,193,190,92,92,323,110,31,31,0,92,7,7,7,7,7,9,2,2,2,8,8,0,2024-01-09 10:00:00,0
5715,5715,5715,5715,2004,86,353,86,216,2004,137,86,212,198,193,86,86,353,137,28,28,0,86,4,4,4,4,3,15,2,2,2,14,14,1,2024-01-09 10:02:00,0
5645,5642,5642,5642,2013,98,307,98,210,2013,97,98,192,187,184,98,98,307,97,28,28,4,98,4,4,4,4,4,9,2,2,2,5,5,0,2024-01-09 10:04:00,0
5685,5688,5688,5688,2008,85,359,85,230,2008,129,85,209,195,193,85,85,359,129,28,28,0,85,4,4,4,4,3,6,2,2,2,14,14,1,2024-01-09 10:06:00,0
5694,5694,5694,5694,2014,93,340,93,213,2014,127,93,190,184,182,93,93,340,127,31,31,2,93,7,7,7,7,7,6,2,2,2,6,6,0,2024-01-09 10:08:00,0
5716,5716,5714,5714,2016,99,337,99,216,2016,121,99,206,198,193,99,99,337,121,28,28,0,99,4,4,4,4,4,15,2,2,2,8,8,0,2024-01-09 10:10:00,0
5698,5699,5699,5699,2011,95,441,95,208,2011,233,95,207,194,190,95,95,441,233,29,29,0,95,4,3,3,3,3,12,2,2,2,13,13,0,2024-01-09 10:12:00,3
5689,5690,5690,5690,2014,90,352,90,221,2014,131,90,192,183,180,90,90,352,131,34,34,0,90,9,8,8,8,8,9,2,2,2,9,9,0,2024-01-09 10:14:00,3
5685,5684,5684,5684,2014,93,329,93,210,2014,119,93,193,185,180,93,93,329,119,27,27,0,93,3,3,3,3,3,15,2,2,2,8,8,0,2024-01-09 10:16:00,0
5724,5727,5725,5725,2022,95,451,95,209,2022,242,95,207,193,188,95,95,451,242,28,28,1,95,4,4,4,4,3,15,2,2,2,14,14,1,2024-01-09 10:18:00,0
5704,5704,5704,5704,2021,90,327,90,218,2021,109,90,201,191,187,90,90,327,109,28,28,0,90,4,4,4,4,4,12,2,2,2,10,10,0,2024-01-09 10:20:00,0
5694,5712,5692,5692,2012,99,433,99,227,2012,206,99,202,190,187,99,99,433,206,31,31,0,99,7,7,7,7,7,9,2,2,2,12,12,0,2024-01-09 10:22:00,0
5706,5706,5706,5706,2033,86,352,86,213,2033,139,86,190,184,183,86,86,352,139,28,28,4,86,4,4,4,4,4,3,2,2,2,6,6,0,2024-01-09 10:24:00,0
5740,5741,5741,5741,2031,87,350,87,220,2031,130,87,199,189,187,87,87,350,130,28,28,0,87,4,4,4,4,4,6,2,2,2,10,10,0,2024-01-09 10:26:00,0
5663,5664,5664,5664,2005,80,337,80,212,2005,125,80,194,185,184,80,80,337,125,28,28,0,80,4,4,4,4,3,3,2,2,2,9,9,1,2024-01-09 10:28:00,0
5765,5765,5765,5765,2038,102,329,102,212,2038,117,102,205,195,194,102,102,329,117,31,31,0,102,7,7,7,7,7,3,2,2,2,10,10,0,2024-01-09 10:30:00,0
5723,5721,5721,5721,2024,98,339,98,208,2024,131,98,204,195,192,98,98,339,131,27,27,0,98,3,3,3,3,3,9,2,2,2,9,9,0,2024-01-09 10:32:00,0
5720,5722,5722,5722,2028,90,333,90,206,2028,127,90,202,190,187,90,90,333,127,28,28,3,90,4,4,4,4,3,9,2,2,2,12,12,1,2024-01-09 10:34:00,0
5755,5755,5755,5755,2028,94,366,94,223,2028,143,94,197,190,188,94,94,366,143,32,32,15,94,8,8,8,8,8,6,2,2,2,7,7,0,2024-01-09 10:36:00,0
5743,5743,5743,5743,2036,99,333,99,213,2036,120,99,199,192,189,99,99,333,120,27,27,0,99,3,3,3,3,3,9,2,2,2,7,7,0,2024-01-09 10:38:00,0
5717,5717,5717,5717,2018,92,331,92,215,2018,116,92,199,190,189,92,92,331,116,28,28,2,92,4,4,4,4,4,3,2,2,2,9,9,0,2024-01-09 10:40:00,0
5698,5698,5698,5698,2018,101,341,101,217,2018,124,101,195,187,184,101,101,341,124,28,28,4,101,4,4,4,4,4,9,2,2,2,8,8,0,2024-01-09 10:42:00,0
5694,5694,5694,5694,2017,100,327,100,218,2017,109,100,205,196,194,100,100,327,109,31,31,4,100,7,7,7,7,6,6,2,2,2,9,9,1,2024-01-09 10:44:00,0
5722,5724,5722,5722,2025,93,351,93,218,2025,133,93,182,175,173,93,93,351,133,28,28,0,93,4,4,4,4,4,6,2,2,2,7,7,0,2024-01-09 10:46:00,0
5685,5685,5685,5685,2021,94,336,94,201,2021,135,94,196,189,185,94,94,336,135,28,28,0,94,4,4,4,4,3,12,2,2,2,7,7,1,2024-01-09 10:48:00,0
5691,5689,5689,5689,2001,101,344,101,210,2001,134,101,205,193,190,101,101,344,134,27,27,2,101,3,3,3,3,3,9,2,2,2,12,12,0,2024-01-09 10:50:00,0
5716,5718,5718,5718,2025,92,439,92,225,2025,214,92,213,203,202,92,92,439,214,34,34,10,92,9,8,8,8,8,3,2,2,2,10,10,0,2024-01-09 10:52:00,3
5758,5758,5758,5758,2019,92,368,92,214,2019,154,92,207,195,191,92,92,368,154,28,28,4,92,4,4,4,4,4,12,2,2,2,12,12,0,2024-01-09 10:54:00,0
5720,5720,5720,5720,2020,95,355,95,215,2020,140,95,208,193,187,95,95,355,140,27,27,0,95,3,3,3,3,3,18,2,2,2,15,15,0,2024-01-09 10:56:00,0
5706,5726,5706,5706,2023,88,461,88,236,2023,225,88,194,192,191,88,88,461,225,32,32,0,88,8,8,8,8,8,3,2,2,2,2,2,0,2024-01-09 10:58:00,0
5684,5683,5683,5683,2020,98,315,98,212,2020,103,98,207,198,195,98,98,315,103,27,27,4,98,3,3,3,3,3,9,2,2,2,9,9,0,2024-01-09 11:00:00,0
5680,5679,5680,5680,2009,93,445,93,215,2009,230,93,193,188,187,93,93,445,230,28,28,10,93,4,4,4,4,3,3,2,2,2,5,5,1,2024-01-09 11:02:00,0
5732,5732,5732,5732,2027,99,435,99,202,2027,233,99,204,201,196,99,99,435,233,28,28,4,99,4,4,4,4,4,15,2,2,2,3,3,0,2024-01-09 11:04:00,0
5709,5709,5709,5709,2019,93,350,93,222,2019,128,93,192,183,183,93,93,350,128,31,31,0,93,7,7,7,7,6,0,2,2,2,9,9,1,2024-01-09 11:06:00,0
5746,5746,5746,5746,2020,94,464,94,220,2020,244,94,206,194,189,94,94,464,244,28,28,0,94,4,4,4,4,4,15,2,2,2,12,12,0,2024-01-09 11:08:00,0
5639,5640,5640,5640,2005,87,328,87,206,2005,122,87,184,175,175,87,87,328,122,28,28,4,87,4,4,4,4,4,0,2,2,2,9,9,0,2024-01-09 11:10:00,0
5734,5733,5733,5733,2020,94,457,94,221,2020,236,94,199,190,190,94,94,457,236,27,27,0,94,3,3,3,3,3,0,2,2,2,9,9,0,2024-01-09 11:12:00,0
5734,5734,5734,5734,2030,84,353,84,222,2030,131,84,215,207,199,84,84,353,131,32,32,2,84,8,8,8,8,8,24,2,2,2,8,8,0,2024-01-09 11:14:00,0
5727,5726,5726,5726,2025,103,330,103,213,2025,117,103,201,195,190,103,103,330,117,27,27,2,103,3,3,3,3,3,15,2,2,2,6,6,0,2024-01-09 11:16:00,0
5726,5724,5724,5724,2019,98,342,98,211,2019,131,98,205,198,196,98,98,342,131,28,28,0,98,4,4,4,4,3,6,2,2,2,7,7,1,2024-01-09 11:18:00,0
5687,5691,5691,5691,2023,92,333,92,212,2023,121,92,193,180,176,92,92,333,121,31,31,4,92,7,7,7,7,7,12,2,2,2,13,13,0,2024-01-09 11:20:00,0
5690,5689,5689,5689,2004,95,358,95,225,2004,133,95,200,191,187,95,95,358,133,34,34,0,95,7,4,4,4,3,12,2,2,2,9,9,1,2024-01-09 11:22:00,9
5738,5733,5733,5733,2032,87,366,87,225,2032,141,87,196,188,183,87,87,366,141,32,32,0,87,6,4,4,4,4,15,2,2,2,8,8,0,2024-01-09 11:24:00,6
5691,5697,5697,5697,2011,102,364,102,228,2011,136,102,199,193,190,102,102,364,136,44,44,2,102,12,4,4,4,4,9,2,2,2,6,6,0,2024-01-09 11:26:00,24
5692,5692,5692,5692,2005,101,358,101,218,2005,140,101,194,187,178,101,101,358,140,31,31,0,101,7,7,7,7,6,27,2,2,2,7,7,1,2024-01-09 11:28:00,0
5650,5649,5649,5649,1995,86,339,86,207,1995,132,86,203,189,186,86,86,339,132,28,28,4,86,4,4,4,4,4,9,2,2,2,14,14,0,2024-01-09 11:30:00,0
5725,5726,5726,5726,2005,97,394,97,217,2005,177,97,204,195,192,97,97,394,177,33,33,0,97,6,3,3,3,3,9,2,2,2,9,9,0,2024-01-09 11:32:00,9
5734,5734,5734,5734,2014,99,393,99,223,2014,170,99,193,186,181,99,99,393,170,28,28,0,99,4,4,4,4,3,15,2,2,2,7,7,1,2024-01-09 11:34:00,0
5707,5706,5706,5706,2026,93,334,93,208,2026,126,93,195,188,185,93,93,334,126,34,34,0,93,6,4,4,4,4,9,2,2,2,7,7,0,2024-01-09 11:36:00,10
5675,5675,5675,5675,2029,81,326,81,222,2029,104,81,195,188,186,81,81,326,104,33,33,3,81,7,7,7,7,7,6,2,2,2,7,7,0,2024-01-09 11:38:00,4
5736,5737,5737,5737,2022,97,345,97,221,2022,124,97,204,195,190,97,97,345,124,28,28,1,97,4,4,4,4,4,15,2,2,2,9,9,0,2024-01-09 11:40:00,2
5724,5726,5724,5724,2010,100,371,100,223,2010,148,100,204,196,192,100,100,371,148,30,30,0,100,5,4,4,4,4,12,2,2,2,8,8,0,2024-01-09 11:42:00,3
5665,5664,5664,5664,2017,92,345,92,215,2017,130,92,197,186,185,92,92,345,130,31,31,0,92,7,7,7,7,6,3,2,2,2,11,11,1,2024-01-09 11:44:00,0
5766,5766,5766,5766,2022,97,380,97,214,2022,166,97,205,201,195,97,97,380,166,28,28,4,97,4,4,4,4,4,18,2,2,2,4,4,0,2024-01-09 11:46:00,0
5698,5698,5698,5698,2025,96,425,96,211,2025,214,96,195,187,186,96,96,425,214,27,27,0,96,3,3,3,3,3,3,2,2,2,8,8,0,2024-01-09 11:48:00,0
5725,5726,5726,5726,2028,88,345,88,219,2028,126,88,196,187,182,88,88,345,126,28,28,0,88,4,4,4,4,3,15,2,2,2,9,9,1,2024-01-09 11:50:00,0
5678,5675,5675,5675,1994,87,372,87,223,1994,149,87,198,189,186,87,87,372,149,37,37,2,87,8,8,8,8,8,9,2,2,2,9,9,0,2024-01-09 11:52:00,12
5734,5737,5737,5737,2019,90,371,90,216,2019,155,90,198,187,185,90,90,371,155,28,28,0,90,4,4,4,4,4,6,2,2,2,11,11,0,2024-01-09 11:54:00,0
5732,5731,5730,5730,2029,90,341,90,213,2029,128,90,203,191,189,90,90,341,128,27,27,12,90,3,3,3,3,3,6,2,2,2,12,12,0,2024-01-09 11:56:00,0
5700,5702,5702,5702,2015,92,343,92,210,2015,133,92,202,190,185,92,92,343,133,28,28,0,92,4,4,4,4,4,15,2,2,2,12,12,0,2024-01-09 11:58:00,0
5726,5725,5725,5725,2027,103,342,103,215,2027,127,103,200,191,188,103,103,342,127,33,33,0,103,8,7,7,7,7,9,2,2,2,9,9,0,2024-01-09 12:00:00,3
5645,5646,5646,5646,1999,87,515,87,215,1999,300,87,194,188,187,87,87,515,300,28,28,4,87,4,4,4,4,3,3,2,2,2,6,6,1,2024-01-09 12:02:00,0
5693,5693,5693,5693,2020,87,312,87,204,2020,108,87,196,185,183,87,87,312,108,28,28,0,87,4,4,4,4,4,6,2,2,2,11,11,0,2024-01-09 12:04:00,0
5730,5729,5729,5729,2024,96,343,96,222,2024,121,96,206,194,191,96,96,343,121,31,31,2,96,7,7,7,7,6,9,2,2,2,12,12,1,2024-01-09 12:06:00,0
5691,5691,5691,5691,2026,86,329,86,226,2026,103,86,202,195,193,86,86,329,103,28,28,0,86,4,4,4,4,4,6,2,2,2,7,7,0,2024-01-09 12:08:00,0
5720,5718,5718,5718,2030,94,340,94,224,2030,116,94,200,194,191,94,94,340,116,28,28,0,94,4,4,4,4,4,9,2,2,2,6,6,0,2024-01-09 12:10:00,0
5692,5693,5693,5693,2015,95,333,95,209,2015,124,95,201,191,186,95,95,333,124,27,27,4,95,3,3,3,3,3,15,2,2,2,10,10,0,2024-01-09 12:12:00,0
5608,5608,5608,5608,1995,87,318,87,226,1995,92,87,191,182,180,87,87,318,92,31,31,0,87,8,8,8,8,8,6,2,2,2,9,9,0,2024-01-09 12:14:00,0
5685,5687,5687,5687,2019,96,329,96,217,2019,112,96,196,188,188,96,96,329,112,27,27,2,96,3,3,3,3,3,0,2,2,2,8,8,0,2024-01-09 12:16:00,0
5716,5716,5716,5716,2038,91,314,91,215,2038,99,91,195,186,181,91,91,314,99,28,28,0,91,4,4,4,4,3,15,2,2,2,9,9,1,2024-01-09 12:18:00,0
5677,5677,5677,5677,2027,100,323,100,216,2027,107,100,186,182,181,100,100,323,107,28,28,0,100,4,4,4,4,4,3,2,2,2,4,4,0,2024-01-09 12:20:00,0
5677,5677,5677,5677,2014,95,428,95,210,2014,218,95,198,187,186,95,95,428,218,31,31,4,95,7,7,7,7,6,3,2,2,2,11,11,1,2024-01-09 12:22:00,0
5655,5655,5655,5655,2016,87,309,87,212,2016,97,87,197,185,182,87,87,309,97,28,28,0,87,4,4,4,4,4,9,2,2,2,12,12,0,2024-01-09 12:24:00,0
5699,5694,5695,5695,2023,73,334,73,210,2023,124,73,208,193,191,73,73,334,124,28,28,2,73,4,4,4,4,4,6,2,2,2,15,15,0,2024-01-09 12:26:00,0
5732,5736,5735,5735,2036,95,312,95,209,2036,103,95,207,193,191,95,95,312,103,31,31,2,95,7,7,7,7,7,6,2,2,2,14,14,0,2024-01-09 12:28:00,0
5731,5731,5731,5731,2030,86,362,86,213,2030,149,86,188,182,178,86,86,362,149,28,28,0,86,4,4,4,4,4,12,2,2,2,6,6,0,2024-01-09 12:30:00,0
5672,5672,5672,5672,2027,96,321,96,209,2027,112,96,193,187,187,96,96,321,112,27,27,4,96,3,3,3,3,3,0,2,2,2,6,6,0,2024-01-09 12:32:00,0
5735,5735,5735,5735,2023,104,349,104,214,2023,135,104,219,202,199,104,104,349,135,28,28,0,104,4,4,4,4,3,9,2,2,2,17,17,1,2024-01-09 12:34:00,0
5696,5696,5696,5696,2026,93,327,93,218,2026,109,93,201,188,186,93,93,327,109,31,31,0,93,7,7,7,7,7,6,2,2,2,13,13,0,2024-01-09 12:36:00,0
5605,5604,5604,5604,1998,86,307,86,206,1998,101,86,189,180,177,86,86,307,101,28,28,2,86,4,4,4,4,3,9,2,2,2,9,9,1,2024-01-09 12:38:00,0
5754,5755,5754,5754,2031,89,337,89,211,2031,126,89,216,204,200,89,89,337,126,28,28,0,89,4,4,4,4,4,12,2,2,2,12,12,0,2024-01-09 12:40:00,0
5722,5723,5723,5723,2009,91,361,91,212,2009,149,91,193,181,180,91,91,361,149,28,28,2,91,4,4,4,4,4,3,2,2,2,12,12,0,2024-01-09 12:42:00,0
5699,5699,5699,5699,2024,96,321,96,217,2024,104,96,195,188,185,96,96,321,104,31,31,0,96,7,7,7,7,7,9,2,2,2,7,7,0,2024-01-09 12:44:00,0
5683,5682,5682,5682,2013,93,326,93,210,2013,116,93,196,185,185,93,93,326,116,28,28,0,93,4,4,4,4,4,0,2,2,2,11,11,0,2024-01-09 12:46:00,0
5713,5714,5714,5714,2029,83,417,83,216,2029,201,83,200,190,186,83,83,417,201,28,28,4,83,4,4,4,4,3,12,2,2,2,10,10,1,2024-01-09 12:48:00,0
5728,5728,5728,5728,2026,89,362,89,218,2026,144,89,203,186,184,89,89,362,144,31,31,0,89,7,7,7,7,7,6,2,2,2,17,17,0,2024-01-09 12:50:00,0
5701,5701,5701,5701,2018,96,342,96,215,2018,127,96,197,183,182,96,96,342,127,28,28,0,96,4,4,4,4,4,3,2,2,2,14,14,0,2024-01-09 12:52:00,0
5750,5750,5750,5750,2036,100,347,100,213,2036,134,100,192,184,178,100,100,347,134,28,28,0,100,4,4,4,4,4,18,2,2,2,8,8,0,2024-01-09 12:54:00,0
5725,5726,5726,5726,2023,97,344,97,218,2023,126,97,198,190,189,97,97,344,126,27,27,0,97,3,3,3,3,3,3,2,2,2,8,8,0,2024-01-09 12:56:00,0
5648,5648,5648,5648,2002,94,361,94,217,2002,144,94,188,182,180,94,94,361,144,32,32,5,94,8,8,8,8,8,6,2,2,2,6,6,0,2024-01-09 12:58:00,0
5687,5687,5687,5687,2019,90,327,90,222,2019,105,90,193,185,182,90,90,327,105,27,27,0,90,3,3,3,3,3,9,2,2,2,8,8,0,2024-01-09 13:00:00,0
5679,5678,5678,5678,2000,102,641,101,212,2000,429,101,205,197,196,101,101,641,429,28,28,0,101,4,4,4,4,3,3,2,2,2,8,8,1,2024-01-09 13:02:00,0
5730,5753,5731,5731,2029,99,441,100,227,2029,214,100,203,197,191,100,100,441,214,28,28,0,100,4,4,4,4,4,18,2,2,2,6,6,0,2024-01-09 13:04:00,0
5699,5697,5697,5697,2021,106,321,106,218,2021,103,106,194,183,182,106,106,321,103,31,31,1,106,7,7,7,7,6,3,2,2,2,11,11,1,2024-01-09 13:06:00,0
5695,5696,5696,5696,2022,98,326,98,216,2022,110,98,203,194,191,98,98,326,110,28,28,4,98,4,4,4,4,4,9,2,2,2,9,9,0,2024-01-09 13:08:00,0
5700,5700,5700,5700,2025,95,334,95,218,2025,116,95,202,190,187,95,95,334,116,28,28,0,95,4,4,4,4,4,9,2,2,2,12,12,0,2024-01-09 13:10:00,0
5716,5716,5717,5717,2027,86,334,86,214,2027,120,86,195,191,189,86,86,334,120,31,31,0,86,7,7,7,7,7,6,2,2,2,4,4,0,2024-01-09 13:12:00,0
5682,5683,5682,5682,2022,87,306,87,209,2022,97,87,202,190,189,87,87,306,97,28,28,2,87,4,4,4,4,4,3,2,2,2,12,12,0,2024-01-09 13:14:00,0
5727,5727,5727,5727,2027,95,329,95,216,2027,113,95,198,187,186,95,95,329,113,27,27,0,95,3,3,3,3,3,3,2,2,2,11,11,0,2024-01-09 13:16:00,0
5708,5708,5708,5708,2025,99,338,99,216,2025,122,99,190,186,185,99,99,338,122,28,28,2,99,4,4,4,4,3,3,2,2,2,4,4,1,2024-01-09 13:18:00,0
5729,5728,5728,5728,2024,91,343,91,226,2024,117,91,194,186,186,91,91,343,117,31,31,0,91,7,7,7,7,7,0,2,2,2,8,8,0,2024-01-09 13:20:00,0
5658,5657,5657,5657,2008,97,332,97,224,2008,108,97,191,189,188,97,97,332,108,28,28,0,97,4,4,4,4,3,3,2,2,2,2,2,1,2024-01-09 13:22:00,0
5730,5732,5732,5732,2025,102,326,102,215,2025,111,102,190,183,183,102,102,326,111,28,28,4,102,4,4,4,4,4,0,2,2,2,7,7,0,2024-01-09 13:24:00,0
5725,5724,5724,5724,2019,95,342,95,214,2019,128,95,204,188,186,95,95,342,128,31,31,0,95,7,7,7,7,7,6,2,2,2,16,16,0,2024-01-09 13:26:00,0
5723,5721,5721,5721,2026,88,340,88,208,2026,132,88,204,190,187,88,88,340,132,28,28,0,88,4,4,4,4,4,9,2,2,2,14,14,0,2024-01-09 13:28:00,0
5657,5660,5660,5660,2016,87,322,87,218,2016,104,87,194,184,182,87,87,322,104,28,28,0,87,4,4,4,4,4,6,2,2,2,10,10,0,2024-01-09 13:30:00,0
7474,7472,7472,7472,2669,114,410,114,277,2669,133,114,252,244,243,114,114,410,133,36,36,0,114,4,4,4,4,3,3,3,3,3,8,8,1,2024-01-09 13:32:00,0
5694,5693,5693,5693,2017,103,328,103,218,2017,110,103,202,192,191,103,103,328,110,31,31,1,103,7,7,7,7,7,3,2,2,2,10,10,0,2024-01-09 13:34:00,0
5695,5696,5696,5696,2015,91,340,91,218,2015,122,91,197,187,183,91,91,340,122,27,27,0,91,3,3,3,3,3,12,2,2,2,10,10,0,2024-01-09 13:36:00,0
5662,5662,5662,5662,2024,93,298,93,205,2024,93,93,194,186,184,93,93,298,93,28,28,0,93,4,4,4,4,3,6,2,2,2,8,8,1,2024-01-09 13:38:00,0
5707,5705,5705,5705,2029,88,321,88,220,2029,101,88,190,183,181,88,88,321,101,28,28,4,88,4,4,4,4,4,6,2,2,2,7,7,0,2024-01-09 13:40:00,0
5713,5715,5715,5715,2019,91,340,91,212,2019,128,91,201,192,189,91,91,340,128,31,31,0,91,7,7,7,7,7,9,2,2,2,9,9,0,2024-01-09 13:42:00,0
5695,5695,5695,5695,2018,85,335,85,210,2018,125,85,192,182,181,85,85,335,125,28,28,4,85,4,4,4,4,4,3,2,2,2,10,10,0,2024-01-09 13:44:00,0
5689,5688,5688,5688,2016,88,326,88,207,2016,119,88,207,201,198,88,88,326,119,28,28,0,88,4,4,4,4,4,9,2,2,2,6,6,0,2024-01-09 13:46:00,0
5722,5723,5723,5723,2020,81,357,81,216,2020,141,81,188,182,179,81,81,357,141,31,31,0,81,7,7,7,7,6,9,2,2,2,6,6,1,2024-01-09 13:48:00,0
5690,5690,5690,5690,2029,90,315,90,215,2029,100,90,194,190,188,90,90,315,100,28,28,4,90,4,4,4,4,4,6,2,2,2,4,4,0,2024-01-09 13:50:00,0
5707,5706,5706,5706,2026,93,325,93,209,2026,116,93,183,179,178,93,93,325,116,28,28,0,93,4,4,4,4,4,3,2,2,2,4,4,0,2024-01-09 13:52:00,0
5619,5620,5620,5620,1998,87,304,87,205,1998,99,87,199,191,191,87,87,304,99,28,28,2,87,4,4,4,4,3,0,2,2,2,8,8,1,2024-01-09 13:54:00,0
5686,5686,5686,5686,2030,86,321,86,219,2030,102,86,198,192,190,86,86,321,102,31,31,0,86,7,7,7,7,7,6,2,2,2,6,6,0,2024-01-09 13:56:00,0
5661,5661,5661,5661,2021,95,321,95,212,2021,109,95,187,180,180,95,95,321,109,27,27,0,95,3,3,3,3,3,0,2,2,2,7,7,0,2024-01-09 13:58:00,0
5714,5714,5714,5714,2031,95,332,95,215,2031,117,95,193,186,184,95,95,332,117,28,28,4,95,4,4,4,4,3,6,2,2,2,7,7,1,2024-01-09 14:00:00,0
5690,5689,5689,5689,2017,86,432,86,207,2017,225,86,196,191,189,86,86,432,225,28,28,0,86,4,4,4,4,4,6,2,2,2,5,5,0,2024-01-09 14:02:00,0
5733,5734,5734,5734,2036,84,335,84,230,2036,105,84,209,200,195,84,84,335,105,31,31,0,84,7,7,7,7,7,15,2,2,2,9,9,0,2024-01-09 14:04:00,0
5681,5681,5681,5681,2015,95,331,95,221,2015,110,95,196,191,184,95,95,331,110,28,28,4,95,4,4,4,4,4,21,2,2,2,5,5,0,2024-01-09 14:06:00,0
5721,5721,5721,5721,2025,100,334,100,208,2025,126,100,191,186,185,100,100,334,126,28,28,0,100,4,4,4,4,4,3,2,2,2,5,5,0,2024-01-09 14:08:00,0
5711,5713,5711,5711,2024,101,324,101,219,2024,105,101,209,198,197,101,101,324,105,31,31,6,101,7,7,7,7,6,3,2,2,2,11,11,1,2024-01-09 14:10:00,0
5702,5700,5700,5700,2028,89,326,89,216,2028,110,89,189,184,183,89,89,326,110,28,28,0,89,4,4,4,4,4,3,2,2,2,5,5,0,2024-01-09 14:12:00,0
5709,5711,5711,5711,2020,94,339,94,208,2020,131,94,199,187,182,94,94,339,131,27,27,0,94,3,3,3,3,3,15,2,2,2,12,12,0,2024-01-09 14:14:00,0
5654,5654,5654,5654,2007,89,323,89,225,2007,98,89,204,196,195,89,89,323,98,28,28,2,89,4,4,4,4,3,3,2,2,2,8,8,1,2024-01-09 14:16:00,0
5659,5659,5659,5659,2004,89,319,89,230,2004,89,89,210,201,200,89,89,319,89,32,32,0,89,8,8,8,8,8,3,2,2,2,9,9,0,2024-01-09 14:18:00,0
5593,5593,5593,5593,2004,84,306,84,215,2004,91,84,189,181,180,84,84,306,91,27,27,4,84,3,3,3,3,3,3,2,2,2,8,8,0,2024-01-09 14:20:00,0
5638,5638,5638,5638,1987,90,303,90,213,1987,90,90,202,193,192,90,90,303,90,28,28,0,90,4,4,4,4,3,3,2,2,2,9,9,1,2024-01-09 14:22:00,0
5706,5705,5705,5705,2016,88,350,88,220,2016,130,88,199,190,188,88,88,350,130,28,28,3,88,4,4,4,4,4,6,2,2,2,9,9,0,2024-01-09 14:24:00,0
5686,5687,5687,5687,2019,104,311,104,213,2019,98,104,207,203,196,104,104,311,98,31,31,6,104,7,7,7,7,7,21,2,2,2,4,4,0,2024-01-09 14:26:00,0
5643,5644,5642,5642,2012,92,318,92,218,2012,100,92,183,178,173,92,92,318,100,28,28,1,92,4,4,4,4,4,15,2,2,2,5,5,0,2024-01-09 14:28:00,0
5666,5667,5667,5667,2023,93,301,93,218,2023,83,93,197,186,183,93,93,301,83,28,28,3,93,4,4,4,4,4,9,2,2,2,11,11,0,2024-01-09 14:30:00,0
5589,5587,5587,5587,1988,91,390,91,213,1988,177,91,190,187,183,91,91,390,177,28,28,1,91,4,4,4,4,3,12,2,2,2,3,3,1,2024-01-09 14:32:00,0
5607,5609,5609,5609,1985,89,315,89,216,1985,99,89,195,191,190,89,89,315,99,31,31,0,89,7,7,7,7,7,3,2,2,2,4,4,0,2024-01-09 14:34:00,0
5671,5671,5671,5671,2018,95,311,95,211,2018,100,95,194,189,187,95,95,311,100,28,28,4,95,4,4,4,4,4,6,2,2,2,5,5,0,2024-01-09 14:36:00,0
5637,5639,5637,5637,2006,99,409,99,220,2006,189,99,199,197,196,99,99,409,189,28,28,0,99,4,4,4,4,3,3,2,2,2,2,2,1,2024-01-09 14:38:00,0
5663,5665,5663,5663,2024,83,311,83,222,2024,89,83,194,189,187,83,83,311,89,27,27,4,83,3,3,3,3,3,6,2,2,2,5,5,0,2024-01-09 14:40:00,0
5647,5647,5647,5647,2003,87,307,87,209,2003,98,87,200,186,185,87,87,307,98,31,31,2,87,7,7,7,7,7,3,2,2,2,14,14,0,2024-01-09 14:42:00,0
5667,5669,5667,5667,2015,93,316,93,206,2015,110,93,195,189,188,93,93,316,110,28,28,0,93,4,4,4,4,3,3,2,2,2,6,6,1,2024-01-09 14:44:00,0
5673,5671,5671,5671,2026,93,297,93,205,2026,92,93,192,184,183,93,93,297,92,28,28,4,93,4,4,4,4,4,3,2,2,2,8,8,0,2024-01-09 14:46:00,0
5656,5658,5658,5658,2018,103,310,103,209,2018,101,103,190,182,182,103,103,310,101,31,31,4,103,7,7,7,7,7,0,2,2,2,8,8,0,2024-01-09 14:48:00,0
5685,5685,5685,5685,2027,94,302,94,213,2027,89,94,201,197,196,94,94,302,89,28,28,1,94,4,4,4,4,4,3,2,2,2,4,4,0,2024-01-09 14:50:00,0
5047,5047,5047,5047,1894,47,290,47,166,1894,124,47,145,138,136,47,47,290,73,29,29,5,47,5,5,4,4,4,6,2,2,2,7,7,0,2024-01-09 14:52:00,52
5228,5230,5228,5228,2018,24,259,24,145,2018,114,24,128,120,118,24,24,259,114,28,28,1,24,4,4,4,4,3,6,2,2,2,8,8,1,2024-01-09 14:54:00,0
5188,5189,5187,5187,2011,24,237,24,148,2011,89,24,129,119,117,24,24,237,89,31,31,5,24,7,7,7,7,7,6,2,2,2,10,10,0,2024-01-09 14:56:00,0
5149,5150,5150,5150,2003,24,217,24,145,2003,72,24,123,119,119,24,24,217,72,29,29,0,24,4,3,3,3,3,0,2,2,2,4,4,0,2024-01-09 14:58:00,3
5112,5114,5112,5112,1985,24,211,24,142,1985,69,24,128,117,117,24,24,211,69,26,26,0,24,3,3,3,3,3,0,2,2,2,11,11,0,2024-01-09 15:00:00,0
5275,5276,5274,5274,1993,24,349,24,144,1993,205,24,138,123,117,24,24,349,205,28,28,3,24,4,4,4,4,4,18,2,2,2,15,15,0,2024-01-09 15:02:00,0
5193,5194,5194,5194,2007,24,253,24,149,2007,104,24,126,122,118,24,24,253,104,31,31,0,24,7,7,7,7,7,12,2,2,2,4,4,0,2024-01-09 15:04:00,2
5228,5231,5228,5228,2021,24,261,24,145,2021,116,24,125,120,119,24,24,261,116,28,28,0,24,4,4,4,4,3,3,2,2,2,5,5,1,2024-01-09 15:06:00,0
5221,5221,5221,5221,2023,24,348,24,146,2023,202,24,127,119,118,24,24,348,202,28,28,5,24,4,4,4,4,4,3,2,2,2,8,8,0,2024-01-09 15:08:00,0
5214,5213,5213,5213,2015,30,261,25,148,2016,113,25,121,118,118,25,24,261,113,31,31,5,24,7,7,7,7,7,0,2,2,2,3,3,0,2024-01-09 15:10:00,2
5190,5190,5190,5190,2018,23,325,23,144,2018,181,23,123,119,118,23,23,325,181,28,28,3,23,4,4,4,4,4,3,2,2,2,4,4,0,2024-01-09 15:12:00,0
5204,5204,5204,5204,2020,23,236,23,145,2020,91,23,128,120,118,23,23,236,91,28,28,0,23,4,4,4,4,4,6,2,2,2,8,8,0,2024-01-09 15:14:00,0
5194,5194,5194,5194,2010,24,241,24,145,2010,96,24,125,120,118,24,24,241,96,28,28,0,24,4,4,4,4,3,6,2,2,2,5,5,1,2024-01-09 15:16:00,0
5235,5236,5236,5236,2029,24,246,24,148,2029,98,24,131,124,118,24,24,246,98,31,31,4,24,7,7,7,7,7,18,2,2,2,7,7,0,2024-01-09 15:18:00,0
5218,5218,5218,5218,2022,24,240,24,144,2022,96,24,128,121,118,24,24,240,96,27,27,0,24,3,3,3,3,3,9,2,2,2,7,7,0,2024-01-09 15:20:00,0
5207,5207,5207,5207,2012,24,353,24,145,2012,208,24,125,118,118,24,24,353,208,28,28,0,24,4,4,4,4,3,0,2,2,2,7,7,1,2024-01-09 15:22:00,0
5200,5222,5200,5200,2004,24,262,24,145,2004,117,24,130,119,118,24,24,262,117,28,28,0,24,4,4,4,4,4,3,2,2,2,11,11,0,2024-01-09 15:24:00,0
5198,5197,5197,5197,2024,24,226,24,148,2024,78,24,124,121,119,24,24,226,78,31,31,1,24,7,7,7,7,7,6,2,2,2,3,3,0,2024-01-09 15:26:00,0
5230,5229,5229,5229,2024,24,245,24,145,2024,100,24,129,121,118,24,24,245,100,28,28,5,24,4,4,4,4,4,9,2,2,2,8,8,0,2024-01-09 15:28:00,0
5201,5202,5202,5202,2021,24,230,24,145,2021,85,24,125,120,118,24,24,230,85,28,28,2,24,4,4,4,4,4,6,2,2,2,5,5,0,2024-01-09 15:30:00,0
5169,5170,5170,5170,2021,24,205,24,149,2021,56,24,126,119,118,24,24,205,56,31,31,2,24,7,7,7,7,6,3,2,2,2,7,7,1,2024-01-09 15:32:00,0
5236,5236,5236,5236,2029,24,243,24,145,2029,98,24,131,123,120,24,24,243,98,28,28,5,24,4,4,4,4,4,9,2,2,2,8,8,0,2024-01-09 15:34:00,0
5253,5253,5253,5253,2042,24,243,24,145,2042,98,24,126,119,118,24,24,243,98,27,27,0,24,3,3,3,3,3,3,2,2,2,7,7,0,2024-01-09 15:36:00,0
5236,5235,5235,5235,2021,23,256,23,146,2021,110,23,132,120,119,23,23,256,110,28,28,2,23,4,4,4,4,3,3,2,2,2,12,12,1,2024-01-09 15:38:00,0
5205,5206,5206,5206,2029,23,224,23,149,2029,75,23,125,120,119,23,23,224,75,32,32,0,23,8,8,8,8,8,3,2,2,2,5,5,0,2024-01-09 15:40:00,0
5199,5198,5198,5198,2007,24,349,24,144,2007,205,24,125,119,118,24,24,349,205,27,27,0,24,3,3,3,3,3,3,2,2,2,6,6,0,2024-01-09 15:42:00,0
5206,5206,5206,5206,2002,24,270,24,146,2002,124,24,131,121,119,24,24,270,124,28,28,0,24,4,4,4,4,4,6,2,2,2,10,10,0,2024-01-09 15:44:00,2
5222,5221,5221,5221,2016,24,257,24,145,2016,112,24,131,121,118,24,24,257,112,28,28,6,24,4,4,4,4,4,9,2,2,2,10,10,0,2024-01-09 15:46:00,0
5206,5209,5207,5207,2011,24,246,24,148,2011,98,24,135,121,119,24,24,246,98,31,31,0,24,7,7,7,7,6,6,2,2,2,14,14,1,2024-01-09 15:48:00,0
5135,5136,5136,5136,1995,24,222,24,143,1995,79,24,131,121,116,24,24,222,79,28,28,0,24,4,4,4,4,4,15,2,2,2,10,10,0,2024-01-09 15:50:00,0
5237,5237,5237,5237,2018,24,365,24,145,2018,220,24,132,121,119,24,24,365,220,28,28,0,24,4,4,4,4,4,6,2,2,2,11,11,0,2024-01-09 15:52:00,0
5228,5228,5228,5228,2023,24,246,24,146,2023,100,24,135,124,120,24,24,246,100,28,28,2,24,4,4,4,4,3,12,2,2,2,11,11,1,2024-01-09 15:54:00,0
5225,5224,5224,5224,2016,24,269,24,147,2016,122,24,124,119,117,24,24,269,122,31,31,0,24,7,7,7,7,7,6,2,2,2,5,5,0,2024-01-09 15:56:00,0
5208,5211,5209,5209,2022,24,233,24,145,2022,88,24,126,119,119,24,24,233,88,27,27,2,24,3,3,3,3,3,0,2,2,2,7,7,0,2024-01-09 15:58:00,0
5250,5247,5247,5247,2027,24,263,24,145,2027,118,24,126,120,118,24,24,263,118,28,28,0,24,4,4,4,4,3,6,2,2,2,6,6,1,2024-01-09 16:00:00,0
